//MAP CONVERTED BY dmm2tgm.py THIS HEADER COMMENT PREVENTS RECONVERSION, DO NOT REMOVE
"a" = (
/obj/decal/cleanable/dirt/random,
/obj/item/cigbutt,
/obj/decal/cleanable/fungus,
/turf/floor/shuttle{
	dir = 8;
	icon_state = "floor3"
	},
/area/dmm_suite/clear_area)
"g" = (
/obj/decal/cleanable/balloon,
/turf/floor/shuttle{
	dir = 8;
	icon_state = "floor3"
	},
/area/dmm_suite/clear_area)
"h" = (
/obj/decal/cleanable/dirt/random,
/obj/item/cigbutt,
/turf/floor/shuttle{
	dir = 8;
	icon_state = "floor3"
	},
/area/dmm_suite/clear_area)
"o" = (
/obj/decal/cleanable/dirt/random,
/obj/item/cigbutt,
/obj/item/cigbutt,
/turf/floor/carpet/green/standard/edge{
	dir = 1
	},
/area/dmm_suite/clear_area)
"q" = (
/obj/decal/cleanable/dirt/random,
/obj/decal/cleanable/mess/chips,
/turf/floor/shuttle{
	dir = 8;
	icon_state = "floor3"
	},
/area/dmm_suite/clear_area)
"u" = (
/obj/decal/cleanable/mess/noodles/random_all,
/turf/floor/carpet/green/standard/edge,
/area/dmm_suite/clear_area)
"v" = (
/turf/floor/shuttle{
	dir = 8;
	icon_state = "floor3"
	},
/area/dmm_suite/clear_area)
"x" = (
/obj/stool/chair/couch/blue{
	dir = 4
	},
/obj/decal/cleanable/dirt/random,
/turf/floor/carpet/green/standard/edge{
	dir = 1
	},
/area/dmm_suite/clear_area)
"z" = (
/obj/decal/cleanable/fungus,
/turf/floor/carpet/green/standard/edge{
	dir = 5
	},
/area/dmm_suite/clear_area)
"G" = (
/obj/decal/cleanable/dirt/random,
/obj/decal/cleanable/mess/sodacan,
/turf/floor/shuttle{
	dir = 8;
	icon_state = "floor3"
	},
/area/dmm_suite/clear_area)
"H" = (
/obj/item/cigbutt,
/turf/floor/carpet/green/standard/edge,
/area/dmm_suite/clear_area)
"J" = (
/turf/floor/carpet/green/standard/edge{
	dir = 6
	},
/area/dmm_suite/clear_area)
"L" = (
/obj/item/cigbutt,
/obj/decal/cleanable/mess/burrito,
/turf/floor/carpet/green/standard/edge{
	dir = 10
	},
/area/dmm_suite/clear_area)
"M" = (
/obj/item/cigbutt,
/turf/floor/shuttle{
	dir = 8;
	icon_state = "floor3"
	},
/area/dmm_suite/clear_area)
"R" = (
/obj/stool/chair/couch/blue{
	dir = 8
	},
/obj/decal/cleanable/dirt/random,
/turf/floor/carpet/green/standard/edge{
	dir = 9
	},
/area/dmm_suite/clear_area)
"U" = (
/obj/decal/cleanable/mess/nougat,
/turf/floor/shuttle{
	dir = 8;
	icon_state = "floor3"
	},
/area/dmm_suite/clear_area)
"V" = (
/obj/stool/chair/couch/blue{
	dir = 1
	},
/obj/decal/cleanable/dirt/random,
/turf/floor/carpet/green/standard/edge{
	dir = 1
	},
/area/dmm_suite/clear_area)
"W" = (
/obj/decal/cleanable/dirt/random,
/turf/floor/carpet/green/standard/edge,
/area/dmm_suite/clear_area)

(1,1,1) = {"
h
U
a
"}
(2,1,1) = {"
R
L
G
"}
(3,1,1) = {"
V
W
v
"}
(4,1,1) = {"
x
u
M
"}
(5,1,1) = {"
o
H
g
"}
(6,1,1) = {"
z
J
q
"}
