//MAP CONVERTED BY dmm2tgm.py THIS HEADER COMMENT PREVENTS RECONVERSION, DO NOT REMOVE
"a" = (
/obj/table/folding/bin,
/obj/item/reagent_containers/food/snacks/plant/potato,
/obj/item/reagent_containers/food/snacks/plant/potato,
/obj/item/reagent_containers/food/snacks/plant/potato,
/obj/item/reagent_containers/food/snacks/plant/potato,
/obj/item/reagent_containers/food/snacks/plant/potato,
/obj/item/reagent_containers/food/snacks/plant/potato,
/obj/item/reagent_containers/food/snacks/plant/potato,
/obj/item/reagent_containers/food/snacks/plant/potato,
/obj/item/reagent_containers/food/snacks/plant/potato,
/obj/item/reagent_containers/food/snacks/plant/potato,
/obj/item/reagent_containers/food/snacks/plant/potato,
/obj/item/reagent_containers/food/snacks/plant/potato,
/turf/floor/shuttle{
	dir = 8;
	icon_state = "floor3"
	},
/area/dmm_suite/clear_area)
"b" = (
/turf/floor/shuttle{
	dir = 8;
	icon_state = "floor3"
	},
/area/dmm_suite/clear_area)
"f" = (
/obj/table/folding/bin,
/obj/item/reagent_containers/food/snacks/plant/potato,
/obj/item/reagent_containers/food/snacks/plant/potato,
/obj/item/reagent_containers/food/snacks/plant/potato,
/obj/item/reagent_containers/food/snacks/plant/potato,
/obj/item/reagent_containers/food/snacks/plant/potato,
/obj/item/reagent_containers/food/snacks/plant/potato,
/obj/item/reagent_containers/food/snacks/plant/potato,
/obj/item/reagent_containers/food/snacks/plant/potato,
/turf/floor/shuttle{
	dir = 8;
	icon_state = "floor3"
	},
/area/dmm_suite/clear_area)
"t" = (
/obj/machinery/deep_fryer,
/turf/floor/shuttle{
	dir = 8;
	icon_state = "floor3"
	},
/area/dmm_suite/clear_area)
"w" = (
/obj/stool/chair/comfy{
	dir = 4
	},
/turf/floor/shuttle{
	dir = 8;
	icon_state = "floor3"
	},
/area/dmm_suite/clear_area)
"A" = (
/obj/table/wood/round,
/obj/item/reagent_containers/food/drinks/water,
/turf/floor/shuttle{
	dir = 8;
	icon_state = "floor3"
	},
/area/dmm_suite/clear_area)
"B" = (
/obj/table/reinforced/kitchen/solid/auto,
/obj/item/kitchen/utensil/knife/steak,
/turf/floor/shuttle{
	dir = 8;
	icon_state = "floor3"
	},
/area/dmm_suite/clear_area)
"K" = (
/obj/storage/secure/closet/fridge,
/obj/item/storage/box/butter,
/obj/item/storage/box/butter,
/obj/item/storage/box/butter,
/obj/item/storage/box/butter,
/turf/floor/shuttle{
	dir = 8;
	icon_state = "floor3"
	},
/area/dmm_suite/clear_area)
"O" = (
/obj/machinery/deep_fryer{
	color = "#FFEEDD";
	name = "Mildly Grody Martha"
	},
/turf/floor/shuttle{
	dir = 8;
	icon_state = "floor3"
	},
/area/dmm_suite/clear_area)
"S" = (
/obj/table/folding/bin,
/obj/item/reagent_containers/food/snacks/plant/potato,
/obj/item/reagent_containers/food/snacks/plant/potato,
/obj/item/reagent_containers/food/snacks/plant/potato,
/obj/item/reagent_containers/food/snacks/plant/potato,
/obj/item/reagent_containers/food/snacks/plant/potato,
/obj/item/reagent_containers/food/snacks/plant/potato,
/obj/item/reagent_containers/food/snacks/plant/potato,
/obj/item/reagent_containers/food/snacks/plant/potato,
/obj/item/reagent_containers/food/snacks/plant/potato,
/obj/item/reagent_containers/food/snacks/plant/potato,
/obj/item/reagent_containers/food/snacks/plant/potato,
/obj/item/reagent_containers/food/snacks/plant/potato,
/obj/item/reagent_containers/food/snacks/plant/potato,
/obj/item/reagent_containers/food/snacks/plant/potato,
/obj/item/reagent_containers/food/snacks/plant/potato,
/obj/item/reagent_containers/food/snacks/plant/potato,
/obj/item/reagent_containers/food/snacks/plant/potato,
/obj/decal/cleanable/dirt/random,
/turf/floor/shuttle{
	dir = 8;
	icon_state = "floor3"
	},
/area/dmm_suite/clear_area)
"U" = (
/obj/table/reinforced/kitchen/solid/auto,
/obj/item/kitchen/utensil/knife/cleaver,
/turf/floor/shuttle{
	dir = 8;
	icon_state = "floor3"
	},
/area/dmm_suite/clear_area)
"Z" = (
/obj/decal/cleanable/dirt/random,
/turf/floor/shuttle{
	dir = 8;
	icon_state = "floor3"
	},
/area/dmm_suite/clear_area)

(1,1,1) = {"
U
Z
a
"}
(2,1,1) = {"
B
b
S
"}
(3,1,1) = {"
t
b
f
"}
(4,1,1) = {"
O
b
b
"}
(5,1,1) = {"
K
b
w
"}
(6,1,1) = {"
Z
b
A
"}
