//MAP CONVERTED BY dmm2tgm.py THIS HEADER COMMENT PREVENTS RECONVERSION, DO NOT REMOVE
"a" = (
/obj/stool/bed,
/obj/item/clothing/suit/bedsheet/random,
/turf/floor/carpet/green/standard/edge{
	dir = 10
	},
/area/dmm_suite/clear_area)
"c" = (
/obj/stool/bed,
/obj/item/clothing/suit/bedsheet/random,
/turf/floor/shuttle{
	dir = 8;
	icon_state = "floor3"
	},
/area/dmm_suite/clear_area)
"d" = (
/obj/stool/bed,
/obj/window/cubicle{
	dir = 4
	},
/obj/item/clothing/suit/bedsheet/gay,
/turf/floor/carpet/red/standard/edge{
	dir = 9
	},
/area/dmm_suite/clear_area)
"e" = (
/obj/window/cubicle{
	dir = 4
	},
/turf/floor/carpet/green/standard/edge{
	dir = 6
	},
/area/dmm_suite/clear_area)
"j" = (
/obj/storage/closet/dresser/random,
/turf/floor/carpet/purple/fancy/edge{
	dir = 5
	},
/area/dmm_suite/clear_area)
"n" = (
/obj/stool/chair/comfy{
	dir = 1
	},
/turf/floor/shuttle{
	dir = 8;
	icon_state = "floor3"
	},
/area/dmm_suite/clear_area)
"o" = (
/turf/floor/carpet/green/standard/edge{
	dir = 9
	},
/area/dmm_suite/clear_area)
"p" = (
/obj/table/wood/round,
/obj/item/reagent_containers/glass/water_pipe,
/turf/floor/carpet/purple/fancy/edge{
	dir = 9
	},
/area/dmm_suite/clear_area)
"u" = (
/turf/floor/carpet/purple/fancy/edge{
	dir = 6
	},
/area/dmm_suite/clear_area)
"w" = (
/turf/floor/carpet/red/standard,
/area/dmm_suite/clear_area)
"z" = (
/turf/floor/shuttle{
	dir = 8;
	icon_state = "floor3"
	},
/area/dmm_suite/clear_area)
"A" = (
/turf/floor/carpet/red/standard/edge{
	dir = 6
	},
/area/dmm_suite/clear_area)
"B" = (
/obj/table/wood/round,
/turf/floor/carpet/purple/fancy/edge,
/area/dmm_suite/clear_area)
"E" = (
/turf/floor/carpet/red/standard/edge,
/area/dmm_suite/clear_area)
"F" = (
/turf/floor/carpet/green/standard/edge{
	dir = 5
	},
/area/dmm_suite/clear_area)
"G" = (
/obj/stool/chair/comfy/green{
	dir = 4
	},
/turf/floor/carpet/red/standard/edge{
	dir = 1
	},
/area/dmm_suite/clear_area)
"Q" = (
/obj/stool/chair/comfy/blue,
/turf/floor/carpet/purple/fancy/edge{
	dir = 1
	},
/area/dmm_suite/clear_area)
"R" = (
/turf/floor/carpet/purple/fancy/edge{
	dir = 10
	},
/area/dmm_suite/clear_area)

(1,1,1) = {"
c
o
a
"}
(2,1,1) = {"
d
F
e
"}
(3,1,1) = {"
G
w
E
"}
(4,1,1) = {"
p
R
A
"}
(5,1,1) = {"
Q
B
n
"}
(6,1,1) = {"
j
u
z
"}
