//MAP CONVERTED BY dmm2tgm.py THIS HEADER COMMENT PREVENTS RECONVERSION, DO NOT REMOVE
"a" = (
/turf/space,
/area/space)
"b" = (
/obj/stool/chair/comfy/shuttle{
	dir = 1
	},
/turf/floor/shuttle_noprotections,
/area/shuttle/escape/centcom/destiny)
"c" = (
/obj/indestructible/shuttle_corner{
	dir = 1;
	icon_state = "wall3_trans"
	},
/turf/space,
/area/shuttle/escape/centcom/destiny)
"d" = (
/obj/machinery/door/airlock/pyro/external/shuttle_connect{
	dir = 4
	},
/turf/floor/shuttle_noprotections,
/area/shuttle/escape/centcom/destiny)
"e" = (
/turf/shuttle/wall/cockpit{
	dir = 8
	},
/area/shuttle/escape/centcom/destiny)
"f" = (
/obj/wingrille_spawn/reinforced,
/obj/machinery/shuttle/engine/heater{
	icon_state = "alt_heater-L"
	},
/turf/floor/shuttle_noprotections{
	icon_state = "plating"
	},
/area/shuttle/escape/centcom/destiny)
"h" = (
/obj/stool/chair/comfy/shuttle{
	dir = 1
	},
/obj/machinery/light{
	dir = 8;
	layer = 9.1;
	pixel_x = -10
	},
/turf/floor/shuttle_noprotections,
/area/shuttle/escape/centcom/destiny)
"k" = (
/obj/indestructible/invisible_block,
/turf/space,
/area/shuttle/escape/centcom/destiny)
"l" = (
/obj/table/auto,
/obj/random_item_spawner/med_kit,
/turf/floor/shuttle_noprotections{
	icon_state = "floor3"
	},
/area/shuttle/escape/centcom/destiny)
"m" = (
/obj/machinery/computer/shuttle/embedded/north,
/obj/stool/chair/comfy/shuttle/pilot{
	dir = 1
	},
/turf/floor/shuttle_noprotections{
	icon_state = "floor2"
	},
/area/shuttle/escape/centcom/destiny)
"o" = (
/turf/wall/r_wall/shuttle_noprotections{
	icon_state = "wall3_floor2"
	},
/area/shuttle/escape/centcom/destiny)
"p" = (
/turf/floor/shuttle_noprotections{
	icon_state = "floor4"
	},
/area/shuttle/escape/centcom/destiny)
"r" = (
/turf/floor/shuttle_noprotections{
	icon_state = "floor3"
	},
/area/shuttle/escape/centcom/destiny)
"t" = (
/obj/machinery/light/small/floor,
/turf/floor/shuttle_noprotections{
	icon_state = "floor4"
	},
/area/shuttle/escape/centcom/destiny)
"u" = (
/obj/machinery/light/small/floor,
/turf/floor/shuttle_noprotections{
	icon_state = "floor3"
	},
/area/shuttle/escape/centcom/destiny)
"v" = (
/turf/wall/r_wall/shuttle_noprotections{
	dir = 4;
	icon_state = "wall3_floor2"
	},
/area/shuttle/escape/centcom/destiny)
"w" = (
/obj/lattice{
	icon_state = "lattice-dir"
	},
/turf/space,
/area/space)
"x" = (
/obj/stool/chair/comfy/shuttle/brown{
	dir = 1
	},
/turf/floor/shuttle_noprotections{
	icon_state = "floor2"
	},
/area/shuttle/escape/centcom/destiny)
"y" = (
/obj/stool/chair/comfy/shuttle/red{
	dir = 1
	},
/turf/floor/shuttle_noprotections{
	icon_state = "floor4"
	},
/area/shuttle/escape/centcom/destiny)
"z" = (
/obj/indestructible/shuttle_corner{
	icon_state = "wall3_trans"
	},
/turf/space,
/area/shuttle/escape/centcom/destiny)
"A" = (
/obj/machinery/sleeper/compact{
	dir = 4
	},
/turf/floor/shuttle_noprotections{
	icon_state = "floor3"
	},
/area/shuttle/escape/centcom/destiny)
"B" = (
/obj/stool/chair/comfy/shuttle,
/obj/machinery/light{
	dir = 4;
	layer = 9.1;
	pixel_x = 10
	},
/turf/floor/shuttle_noprotections,
/area/shuttle/escape/centcom/destiny)
"C" = (
/obj/wingrille_spawn/reinforced,
/turf/floor/shuttle_noprotections{
	icon_state = "plating"
	},
/area/shuttle/escape/centcom/destiny)
"D" = (
/obj/stool/chair/comfy/shuttle,
/turf/floor/shuttle_noprotections,
/area/shuttle/escape/centcom/destiny)
"E" = (
/obj/wingrille_spawn/reinforced,
/obj/machinery/shuttle/engine/heater{
	icon_state = "alt_heater-M"
	},
/turf/floor/shuttle_noprotections{
	icon_state = "plating"
	},
/area/shuttle/escape/centcom/destiny)
"F" = (
/obj/machinery/door/airlock/pyro/glass/command{
	dir = 1
	},
/obj/access_spawn/heads,
/turf/floor/shuttle_noprotections{
	icon_state = "floor2"
	},
/area/shuttle/escape/centcom/destiny)
"G" = (
/obj/machinery/light/small/floor,
/turf/floor/shuttle_noprotections{
	icon_state = "floor2"
	},
/area/shuttle/escape/centcom/destiny)
"H" = (
/obj/wingrille_spawn/reinforced,
/turf/floor/shuttle{
	icon_state = "plating"
	},
/area/shuttle/escape/centcom/destiny)
"I" = (
/obj/machinery/shuttle/engine/propulsion{
	icon_state = "alt_propulsion"
	},
/turf/space,
/area/shuttle/escape/centcom/destiny)
"K" = (
/obj/indestructible/shuttle_corner{
	dir = 4;
	icon_state = "wall3_trans"
	},
/turf/space,
/area/shuttle/escape/centcom/destiny)
"L" = (
/turf/wall/r_wall/shuttle_noprotections,
/area/shuttle/escape/centcom/destiny)
"M" = (
/obj/stool/chair/comfy/shuttle,
/obj/machinery/light{
	dir = 8;
	layer = 9.1;
	pixel_x = -10
	},
/turf/floor/shuttle_noprotections,
/area/shuttle/escape/centcom/destiny)
"N" = (
/obj/stool/chair/comfy/shuttle{
	dir = 1
	},
/obj/machinery/light{
	dir = 4;
	layer = 9.1;
	pixel_x = 10
	},
/turf/floor/shuttle_noprotections,
/area/shuttle/escape/centcom/destiny)
"O" = (
/obj/machinery/door/airlock/pyro/medical{
	name = "First-Aid Station"
	},
/turf/floor/shuttle_noprotections{
	icon_state = "floor3"
	},
/area/shuttle/escape/centcom/destiny)
"Q" = (
/obj/table/reinforced/auto,
/turf/floor/shuttle_noprotections{
	icon_state = "floor2"
	},
/area/shuttle/escape/centcom/destiny)
"R" = (
/obj/stool/chair/comfy/shuttle/green{
	dir = 8
	},
/turf/floor/shuttle_noprotections{
	icon_state = "floor3"
	},
/area/shuttle/escape/centcom/destiny)
"S" = (
/obj/lattice{
	dir = 1;
	icon_state = "lattice-dir-b"
	},
/turf/space,
/area/space)
"T" = (
/turf/floor/shuttle_noprotections,
/area/shuttle/escape/centcom/destiny)
"U" = (
/obj/wingrille_spawn/reinforced,
/obj/machinery/shuttle/engine/heater{
	icon_state = "alt_heater-R"
	},
/turf/floor/shuttle_noprotections{
	icon_state = "plating"
	},
/area/shuttle/escape/centcom/destiny)
"W" = (
/obj/machinery/light/small/floor,
/turf/floor/shuttle_noprotections,
/area/shuttle/escape/centcom/destiny)
"X" = (
/obj/machinery/door/airlock/pyro/security{
	name = "Secure Transport"
	},
/obj/access_spawn/security,
/turf/floor/shuttle_noprotections{
	icon_state = "floor4"
	},
/area/shuttle/escape/centcom/destiny)
"Y" = (
/obj/indestructible/shuttle_corner{
	dir = 8;
	icon_state = "wall3_trans"
	},
/turf/space,
/area/shuttle/escape/centcom/destiny)
"Z" = (
/turf/wall/r_wall/shuttle_noprotections{
	icon_state = "wall3"
	},
/area/shuttle/escape/centcom/destiny)

(1,1,1) = {"
w
w
w
S
Y
Z
d
C
C
C
d
Z
Z
Z
Z
Z
z
a
"}
(2,1,1) = {"
a
a
Y
C
Z
M
T
b
b
b
T
h
Z
A
A
A
f
I
"}
(3,1,1) = {"
S
Y
v
Q
H
D
T
b
b
b
T
T
O
r
u
r
E
I
"}
(4,1,1) = {"
k
L
x
x
Z
D
T
b
b
b
T
b
Z
R
l
R
U
I
"}
(5,1,1) = {"
e
L
m
G
F
T
T
T
W
T
T
b
Z
Z
Z
Z
Z
a
"}
(6,1,1) = {"
k
L
x
x
Z
D
T
b
b
b
T
b
Z
y
y
y
f
I
"}
(7,1,1) = {"
S
c
o
Q
C
D
T
b
b
b
T
T
X
p
t
p
E
I
"}
(8,1,1) = {"
a
a
c
C
Z
B
T
b
b
b
T
N
Z
y
y
y
U
I
"}
(9,1,1) = {"
w
w
w
S
c
Z
d
C
C
C
d
Z
Z
Z
Z
Z
K
a
"}
