//MAP CONVERTED BY dmm2tgm.py THIS HEADER COMMENT PREVENTS RECONVERSION, DO NOT REMOVE
"a" = (
/turf/outdoors/grass,
/area/centcom/outside)
"c" = (
/obj/indestructible/shuttle_corner{
	dir = 1
	},
/turf/outdoors/grass,
/area/shuttle/escape/centcom/destiny)
"d" = (
/obj/machinery/door/airlock/pyro/external{
	dir = 4
	},
/turf/floor/shuttle,
/area/shuttle/escape/centcom/destiny)
"e" = (
/turf/shuttle/wall/cockpit{
	dir = 8
	},
/area/shuttle/escape/centcom/destiny)
"f" = (
/obj/wingrille_spawn/auto,
/obj/machinery/shuttle/engine/heater{
	icon_state = "alt_heater-L"
	},
/turf/floor/plating,
/area/shuttle/escape/centcom/destiny)
"g" = (
/turf/wall/auto/shuttle{
	icon_state = "13"
	},
/area/shuttle/escape/centcom/destiny)
"i" = (
/turf/wall/auto/shuttle{
	icon_state = "3"
	},
/area/shuttle/escape/centcom/destiny)
"k" = (
/obj/indestructible/invisible_block,
/turf/outdoors/grass,
/area/shuttle/escape/centcom/destiny)
"m" = (
/obj/machinery/computer/shuttle/embedded/north,
/turf/floor/shuttle,
/area/shuttle/escape/centcom/destiny)
"o" = (
/obj/indestructible/shuttle_corner{
	dir = 4
	},
/turf/floor/shuttle,
/area/shuttle/escape/centcom/destiny)
"q" = (
/turf/wall/auto/shuttle{
	icon_state = "7"
	},
/area/shuttle/escape/centcom/destiny)
"v" = (
/obj/indestructible/shuttle_corner{
	dir = 8
	},
/turf/floor/shuttle,
/area/shuttle/escape/centcom/destiny)
"w" = (
/obj/lattice{
	icon_state = "lattice-dir"
	},
/turf/outdoors/grass,
/area/centcom/outside)
"x" = (
/turf/floor/shuttle,
/area/shuttle/escape/centcom/destiny)
"z" = (
/obj/indestructible/shuttle_corner{
	dir = 4
	},
/turf/outdoors/grass,
/area/shuttle/escape/centcom/destiny)
"C" = (
/obj/wingrille_spawn/auto,
/turf/floor/shuttle,
/area/shuttle/escape/centcom/destiny)
"E" = (
/obj/wingrille_spawn/auto,
/obj/machinery/shuttle/engine/heater{
	icon_state = "alt_heater-M"
	},
/turf/floor/plating,
/area/shuttle/escape/centcom/destiny)
"I" = (
/obj/machinery/shuttle/engine/propulsion{
	icon_state = "alt_propulsion"
	},
/turf/outdoors/grass,
/area/shuttle/escape/centcom/destiny)
"K" = (
/obj/indestructible/shuttle_corner{
	dir = 8
	},
/turf/outdoors/grass,
/area/shuttle/escape/centcom/destiny)
"L" = (
/turf/wall/auto/shuttle,
/area/shuttle/escape/centcom/destiny)
"S" = (
/obj/lattice{
	dir = 1;
	icon_state = "lattice-dir-b"
	},
/turf/outdoors/grass,
/area/centcom/outside)
"U" = (
/obj/wingrille_spawn/auto,
/obj/machinery/shuttle/engine/heater{
	icon_state = "alt_heater-R"
	},
/turf/floor/plating,
/area/shuttle/escape/centcom/destiny)
"V" = (
/turf/wall/auto/shuttle{
	icon_state = "1"
	},
/area/shuttle/escape/centcom/destiny)
"Y" = (
/obj/indestructible/shuttle_corner{
	dir = 0
	},
/turf/outdoors/grass,
/area/shuttle/escape/centcom/destiny)
"Z" = (
/turf/wall/auto/shuttle{
	icon_state = "11"
	},
/area/shuttle/escape/centcom/destiny)

(1,1,1) = {"
w
w
w
S
Y
Z
d
C
C
C
d
Z
q
i
i
i
z
a
"}
(2,1,1) = {"
a
a
Y
C
g
x
x
x
x
x
x
x
x
x
x
x
f
I
"}
(3,1,1) = {"
S
Y
v
x
x
x
x
x
x
x
x
x
x
x
x
x
E
I
"}
(4,1,1) = {"
k
L
x
x
x
x
x
x
x
x
x
x
x
x
x
x
U
I
"}
(5,1,1) = {"
e
L
m
x
x
x
x
x
x
x
x
x
x
x
x
x
V
a
"}
(6,1,1) = {"
k
L
x
x
x
x
x
x
x
x
x
x
x
x
x
x
f
I
"}
(7,1,1) = {"
S
c
o
x
x
x
x
x
x
x
x
x
x
x
x
x
E
I
"}
(8,1,1) = {"
a
a
c
C
g
x
x
x
x
x
x
x
x
x
x
x
U
I
"}
(9,1,1) = {"
w
w
w
S
c
q
d
C
C
C
d
q
Z
i
i
i
K
a
"}
