"a" = (/obj/decal/cleanable/tracked_reagents/blood/splatter/extra,/turf/floor/airless/red,/area/centcom/offices)
"k" = (/obj/storage/secure/closet/fridge/blood,/obj/decal/cleanable/tracked_reagents/blood/splatter/extra,/turf/floor/airless/red,/area/centcom/offices)
"l" = (/obj/decal/poster/wallsign/warning3,/turf/wall,/area/centcom/offices)
"p" = (/obj/decal/fakeobjects/core,/turf/floor/airless/red,/area/centcom/offices)
"q" = (/obj/table/folding,/turf/floor/airless/red,/area/centcom/offices)
"s" = (/obj/decal/poster/wallsign/pride/asexual,/turf/wall,/area/centcom/offices)
"t" = (/obj/decal/poster/wallsign/pride/transgender,/turf/wall,/area/centcom/offices)
"u" = (/obj/table/folding,/obj/machinery/computer3/generic/personal,/turf/floor/airless/red,/area/centcom/offices)
"x" = (/obj/machinery/optable,/obj/decal/cleanable/tracked_reagents/blood/splatter/extra,/turf/floor/airless/red,/area/centcom/offices)
"z" = (/obj/stool/chair/office/purple,/turf/floor/airless/red,/area/centcom/offices)
"D" = (/obj/neon_sign/syndie,/turf/wall,/area/centcom/offices)
"H" = (/turf/floor/airless/red,/area/centcom/offices)
"I" = (/obj/decal/cleanable/tooth,/turf/floor/airless/red,/area/centcom/offices)
"K" = (/turf/wall/false_wall,/area/centcom/offices)
"N" = (/obj/crematorium,/obj/decal/cleanable/tracked_reagents/blood/drip/low,/turf/floor/airless/red,/area/centcom/offices)
"P" = (/obj/decal/poster/wallsign/clown_calendar/bridge,/turf/wall,/area/centcom/offices)
"U" = (/obj/machinery/portable_atmospherics/canister/oxygen_agent_b,/obj/decal/cleanable/tracked_reagents/blood/splatter/extra,/turf/floor/airless/red,/area/centcom/offices)
"V" = (/obj/decal/cleanable/gangtag{icon_state = "gangtag12"},/turf/wall,/area/centcom/offices)
"W" = (/turf/wall,/area/centcom/offices)
"Y" = (/obj/machinery/door/airlock/classic,/turf/floor/airless/red,/area/centcom/offices)

(1,1,1) = {"
WsDPtW
WUkxNV
WaaHHY
WHaIHl
WuaHHK
WzHHqW
WHpHqW
WWWWWW
"}
