//MAP CONVERTED BY dmm2tgm.py THIS HEADER COMMENT PREVENTS RECONVERSION, DO NOT REMOVE
"a" = (
/turf/space,
/area/space)
"c" = (
/turf/simulated/shuttle/wall/corner{
	dir = 1
	},
/area/space)
"f" = (
/obj/storage/crate/freezer,
/obj/item/reagent_containers/food/drinks/bottle/fancy_beer,
/obj/item/reagent_containers/food/drinks/bottle/fancy_beer,
/obj/item/reagent_containers/food/drinks/bottle/fancy_beer,
/obj/item/reagent_containers/food/drinks/bottle/fancy_beer,
/obj/item/reagent_containers/food/drinks/bottle/fancy_beer,
/obj/item/reagent_containers/food/drinks/bottle/fancy_beer,
/obj/item/reagent_containers/food/drinks/bottle/fancy_beer,
/obj/item/reagent_containers/food/drinks/rum_spaced,
/obj/item/reagent_containers/food/drinks/bottle/soda/grones,
/obj/item/reagent_containers/food/drinks/bottle/soda/grones,
/turf/unsimulated/floor/shuttle,
/area/space)
"h" = (
/turf/unsimulated/floor/stairs/wide/other{
	dir = 8
	},
/area/space)
"i" = (
/obj/machinery/computer3/terminal/console_upper,
/obj/decal/fakeobjects{
	desc = "While not as powerful as the Hudgeasse line of speakers, it is the go to choice for a juicer on a budget.";
	icon = 'icons/obj/items/device.dmi';
	icon_state = "loudspeaker";
	name = "Mini Funk Boomers Mk 3400";
	pixel_y = 32
	},
/turf/unsimulated/floor/shuttle,
/area/space)
"j" = (
/obj/reagent_dispensers/beerkeg{
	pixel_x = 6;
	pixel_y = 11
	},
/obj/reagent_dispensers/beerkeg{
	pixel_x = -7;
	pixel_y = 5
	},
/obj/reagent_dispensers/beerkeg{
	pixel_x = 8;
	pixel_y = -3
	},
/turf/unsimulated/floor/shuttle,
/area/space)
"k" = (
/obj/machinery/door/poddoor/blast/single,
/turf/unsimulated/floor/shuttle,
/area/space)
"m" = (
/obj/decal/fakeobjects/operatorconsole,
/turf/unsimulated/floor/shuttle,
/area/space)
"n" = (
/obj/table/reinforced/bar,
/obj/item/reagent_containers/food/drinks/bottle/bojackson{
	pixel_x = 7;
	pixel_y = 14
	},
/obj/item/reagent_containers/food/drinks/bottle/vintage{
	pixel_x = 6;
	pixel_y = 10
	},
/obj/window/thindow{
	dir = 1
	},
/turf/unsimulated/floor/shuttle,
/area/space)
"o" = (
/obj/machinery/computer/announcement/console_lower{
	dir = 8
	},
/turf/unsimulated/floor/shuttle,
/area/space)
"p" = (
/turf/unsimulated/floor/stairs/wide{
	dir = 4
	},
/area/space)
"q" = (
/obj/table/reinforced/bar,
/obj/item/reagent_containers/food/drinks/drinkingglass/shot{
	pixel_x = 8;
	pixel_y = 11
	},
/obj/item/reagent_containers/food/drinks/drinkingglass/shot{
	pixel_y = 7
	},
/obj/item/reagent_containers/food/drinks/drinkingglass/shot/syndie{
	pixel_x = 16;
	pixel_y = 7
	},
/obj/item/reagent_containers/food/drinks/bottle/fancy_beer,
/turf/unsimulated/floor/shuttle,
/area/space)
"r" = (
/turf/unsimulated/floor/stairs/wide/middle{
	dir = 8
	},
/area/space)
"t" = (
/obj/machinery/computer3/generic/engine/console_upper{
	dir = 8
	},
/turf/unsimulated/floor/shuttle,
/area/space)
"v" = (
/turf/simulated/shuttle/wall/corner{
	dir = 8
	},
/area/space)
"w" = (
/obj/disco_ball,
/turf/unsimulated/floor/carpet/clowncarpet,
/area/space)
"y" = (
/obj/table/reinforced/bar,
/obj/item/reagent_containers/food/drinks/drinkingglass/shot{
	pixel_y = 6
	},
/obj/item/reagent_containers/food/drinks/drinkingglass/shot{
	pixel_x = -10;
	pixel_y = 12
	},
/turf/unsimulated/floor/shuttle,
/area/space)
"z" = (
/obj/table/auto{
	icon_state = "9"
	},
/turf/unsimulated/floor/shuttle,
/area/space)
"C" = (
/turf/unsimulated/floor/stairs/wide/middle{
	dir = 4
	},
/area/space)
"D" = (
/obj/decal/fakeobjects{
	desc = "While not as powerful as the Hudgeasse line of speakers, it is the go to choice for a juicer on a budget.";
	icon = 'icons/obj/items/device.dmi';
	icon_state = "loudspeaker";
	name = "Mini Funk Boomers Mk 3400";
	pixel_y = 32
	},
/turf/unsimulated/floor/shuttle,
/area/space)
"F" = (
/turf/simulated/shuttle/wall/corner,
/area/space)
"G" = (
/obj/stool/chair/comfy/shuttle/pilot{
	dir = 4
	},
/turf/unsimulated/floor/shuttle,
/area/space)
"J" = (
/turf/unsimulated/floor/stairs/wide{
	dir = 8
	},
/area/space)
"L" = (
/obj/table/auto{
	icon_state = "4"
	},
/obj/item/reagent_containers/food/drinks/energyshake{
	color = "#BBFFDD";
	desc = "What's in this?";
	initial_reagents = list("energydrink" = 20, "salbutamol" = 5);
	name = "Ultra High Pressure Shake";
	pixel_x = 8;
	pixel_y = 6
	},
/obj/machinery/conveyor_switch{
	desc = "A lever.";
	name = "Lever";
	pixel_y = 12
	},
/obj/item/reagent_containers/food/drinks/energyshake,
/turf/unsimulated/floor/shuttle,
/area/space)
"M" = (
/obj/stool/chair/comfy/shuttle,
/turf/unsimulated/floor/shuttle,
/area/space)
"N" = (
/obj/decal/fakeobjects{
	desc = "While not as powerful as the Hudgeasse line of speakers, it is the go to choice for a juicer on a budget.";
	icon = 'icons/obj/items/device.dmi';
	icon_state = "loudspeaker";
	name = "Mini Funk Boomers Mk 3400";
	pixel_y = -32
	},
/turf/unsimulated/floor/shuttle,
/area/space)
"O" = (
/obj/table/folding,
/obj/item/reagent_containers/food/drinks/bottle/fancy_beer{
	pixel_x = 8;
	pixel_y = 6
	},
/obj/item/reagent_containers/food/drinks/bottle/beer{
	pixel_x = -5;
	pixel_y = 5
	},
/obj/decal/fakeobjects{
	desc = "While not as powerful as the Hudgeasse line of speakers, it is the go to choice for a juicer on a budget.";
	icon = 'icons/obj/items/device.dmi';
	icon_state = "loudspeaker";
	name = "Mini Funk Boomers Mk 3400";
	pixel_y = 32
	},
/turf/unsimulated/floor/shuttle,
/area/space)
"P" = (
/turf/unsimulated/floor/stairs/wide/other,
/area/space)
"R" = (
/turf/simulated/shuttle/wall/corner{
	dir = 4
	},
/area/space)
"S" = (
/obj/machinery/mass_driver{
	dir = 4
	},
/turf/unsimulated/floor/shuttle,
/area/space)
"T" = (
/turf/unsimulated/floor/carpet/clowncarpet,
/area/space)
"U" = (
/turf/simulated/shuttle/wall,
/area/space)
"V" = (
/obj/machinery/door/airlock/pyro/alt,
/turf/unsimulated/floor/shuttle,
/area/space)
"W" = (
/turf/unsimulated/floor/shuttle,
/area/space)
"X" = (
/turf/unsimulated/floor/stairs/wide/middle,
/area/space)
"Y" = (
/turf/unsimulated/floor/stairs/wide/other{
	dir = 4
	},
/area/space)
"Z" = (
/turf/unsimulated/floor/stairs/wide,
/area/space)

(1,1,1) = {"
a
a
a
a
a
a
a
a
a
"}
(2,1,1) = {"
a
v
U
U
U
U
U
F
a
"}
(3,1,1) = {"
a
U
m
W
W
W
W
U
a
"}
(4,1,1) = {"
a
U
i
G
L
W
N
U
a
"}
(5,1,1) = {"
v
U
t
o
z
W
W
U
F
"}
(6,1,1) = {"
U
W
W
W
W
W
W
W
U
"}
(7,1,1) = {"
U
D
W
p
C
Y
W
N
U
"}
(8,1,1) = {"
U
W
Z
T
T
T
Z
W
U
"}
(9,1,1) = {"
V
W
X
T
w
T
X
W
V
"}
(10,1,1) = {"
U
W
P
T
T
T
P
W
U
"}
(11,1,1) = {"
U
D
W
h
r
J
W
N
U
"}
(12,1,1) = {"
U
j
W
W
W
W
W
W
U
"}
(13,1,1) = {"
c
U
M
W
W
q
W
U
R
"}
(14,1,1) = {"
a
U
O
W
W
y
N
U
a
"}
(15,1,1) = {"
a
U
M
W
W
n
f
U
a
"}
(16,1,1) = {"
a
c
U
U
S
U
U
R
a
"}
(17,1,1) = {"
a
a
a
c
k
R
a
a
a
"}
