"a" = (/turf/floor/plating/gehenna,/area/space)
"e" = (/obj/storage/cart/trash,/obj/item/clothing/under/trash_bag{pixel_x = -14; pixel_y = -14},/obj/item/clothing/under/trash_bag{pixel_x = 14; pixel_y = -14},/obj/item/clothing/under/trash_bag{pixel_x = 0; pixel_y = -18},/turf/floor/plating/gehenna,/area/space)

(1,1,1) = {"
aea
aaa
"}
