//MAP CONVERTED BY dmm2tgm.py THIS HEADER COMMENT PREVENTS RECONVERSION, DO NOT REMOVE
"a" = (
/turf/floor/plating/gehenna,
/area/space)
"e" = (
/obj/storage/cart/trash,
/obj/item/clothing/under/trash_bag{
	pixel_x = -14;
	pixel_y = -14
	},
/obj/item/clothing/under/trash_bag{
	pixel_x = 14;
	pixel_y = -14
	},
/obj/item/clothing/under/trash_bag{
	pixel_x = 0;
	pixel_y = -18
	},
/turf/floor/plating/gehenna,
/area/space)

(1,1,1) = {"
a
a
"}
(2,1,1) = {"
e
a
"}
(3,1,1) = {"
a
a
"}
