"a" = (/turf/space,/area/space)
"p" = (/obj/random_item_spawner/landmine,/turf/floor/plating/gehenna,/area/noGenerate)
"t" = (/turf/wall/asteroid/gehenna/tough/z3,/area/noGenerate)
"R" = (/turf/floor/plating/gehenna,/area/noGenerate)

(1,1,1) = {"
tRtaaaa
tRRtaaa
atpRtaa
atRRRta
aatRpta
aaatRRt
aaaatRR
"}
