//MAP CONVERTED BY dmm2tgm.py THIS HEADER COMMENT PREVENTS RECONVERSION, DO NOT REMOVE
"a" = (
/turf/variableTurf/wall,
/area/allowGenerate)
"q" = (
/turf/floor/plating/gehenna,
/area/noGenerate)
"y" = (
/turf/wall/asteroid/gehenna/z3/fun,
/area/noGenerate)
"z" = (
/turf/wall/asteroid/gehenna/tough/z3,
/area/allowGenerate)

(1,1,1) = {"
a
a
z
z
z
z
z
a
a
a
a
a
a
a
"}
(2,1,1) = {"
a
a
z
q
q
q
z
z
a
a
a
z
z
z
"}
(3,1,1) = {"
a
a
z
q
q
q
q
z
z
z
z
q
q
z
"}
(4,1,1) = {"
a
a
z
z
q
q
q
q
z
q
q
q
q
z
"}
(5,1,1) = {"
a
z
z
q
q
q
q
q
q
q
q
q
z
z
"}
(6,1,1) = {"
a
z
q
q
q
q
q
q
q
q
q
q
z
a
"}
(7,1,1) = {"
z
z
q
q
q
q
q
q
q
q
q
z
z
a
"}
(8,1,1) = {"
z
q
q
q
q
q
q
y
q
q
q
z
a
a
"}
(9,1,1) = {"
z
z
z
z
z
q
q
q
q
q
q
z
z
a
"}
(10,1,1) = {"
a
a
a
a
z
q
q
q
q
q
q
q
z
a
"}
(11,1,1) = {"
a
a
a
z
z
q
q
q
z
q
q
q
z
a
"}
(12,1,1) = {"
a
a
a
z
q
q
q
z
z
z
z
q
z
a
"}
(13,1,1) = {"
a
a
a
z
q
z
z
z
a
a
z
z
z
a
"}
(14,1,1) = {"
a
a
a
z
z
z
a
a
a
a
a
a
a
a
"}
