"a" = (/turf/space,/area/space)
"k" = (/obj/lattice,/obj/grille/steel/broken,/turf/simulated/floor/plating/random,/area/space)
"l" = (/obj/item/clothing/glasses/sunglasses/tanning,/turf/simulated/floor/plating/random,/area/space)
"o" = (/obj/lattice,/turf/simulated/floor/gehenna,/area/space)
"r" = (/turf/simulated/wall/r_wall,/area/space)
"t" = (/obj/item/parts/human_parts/leg/mutant/skeleton/left,/turf/simulated/floor/gehenna,/area/space)
"u" = (/obj/item/inner_tube,/turf/simulated/floor/gehenna,/area/space)
"v" = (/obj/grille/steel,/turf/simulated/floor/plating/random,/area/space)
"x" = (/obj/decal/poster/wallsign/stencil/left/o,/obj/decal/poster/wallsign/stencil/right/l,/turf/simulated/wall/r_wall,/area/space)
"y" = (/obj/decal/skeleton,/turf/simulated/floor/gehenna,/area/space)
"A" = (/obj/grille/steel/broken,/turf/simulated/floor/plating/random,/area/space)
"C" = (/turf/simulated/floor/gehenna,/area/space)
"D" = (/obj/lattice,/obj/item/clothing/suit/space/emerg,/turf/simulated/floor/plating/random,/area/space)
"E" = (/turf/simulated/floor/plating/random,/area/space)
"F" = (/obj/item/reagent_containers/food/drinks/fueltank/chlorine,/turf/simulated/floor/plating/random,/area/space)
"J" = (/obj/lattice,/obj/grille/steel/broken,/turf/simulated/floor/gehenna,/area/space)
"K" = (/obj/decal/poster/wallsign/stencil/left/p,/obj/decal/poster/wallsign/stencil/right/o,/turf/simulated/wall/r_wall,/area/space)
"L" = (/obj/item/clothing/under/towel,/turf/simulated/floor/plating/random,/area/space)
"N" = (/obj/grille/steel,/turf/simulated/floor/gehenna,/area/space)
"O" = (/obj/item/bandage,/turf/simulated/floor/gehenna,/area/space)
"P" = (/obj/critter/spirit,/turf/simulated/floor/gehenna,/area/space)
"V" = (/turf/simulated/wall/asteroid/gehenna/z3/tough,/area/space)
"W" = (/obj/lattice,/obj/item/wirecutters,/turf/simulated/floor/plating/random,/area/space)
"X" = (/obj/item/material_piece/bone{name = "grody bone"},/obj/grille/steel/broken,/turf/simulated/floor/plating/random,/area/space)
"Y" = (/obj/item/parts/human_parts/arm/mutant/skeleton/left,/turf/simulated/floor/plating/random,/area/space)
"Z" = (/obj/lattice,/turf/simulated/floor/plating/random,/area/space)

(1,1,1) = {"
aaaaaaaaaaaaaaaaaaaaaaaaa
aaCaaaaaaaaaaaaaaaaaCaaaa
aCCCaaaaaaaaaaaaaaaaCCaaa
aaCCCCCaaaaaaCCaaaaaCCaaa
aaaCCCCCCCCCCCCraaarCCaaa
aaaaCCCCCCCCCCCCCaaNCCaaa
aaaaaCCCCCVVrCCCCCCNCECaa
aaaaaECCVVVVVVVVCCCCCCFCa
aaaaaCCCVVVVVVVVVVCCZYCCC
aaaaCCCVVVVVCVVVVVCoWCCCC
aaaaCCCCVVVVCuVVVVVvCCCaa
aaaaCCCVVVVNCoVVVVrACCaaa
aaaaCCCaarNyPJVVVVrNCaaaa
aaaaCCCarrOoCVVVVraCCaaaa
aaaCCCCrroCCVVVVKxaCCaaaa
aaCCCCCrCCCCVVrrlaaCCaaaa
aaCCCCCCCCtVVrraaaaCCraaa
aaaaCCCCCXVVrrLaaarCCCaaa
aaaarCCCCDkoZEaaaaCCCCaaa
aaaaVCCCCCCoCaaaaCCCCCaaa
aaaaVVCCCCCCCCCCCCCCCaaaa
aaCCCVVrCCCCCCCCCCCaaaaaa
aaCCCrraaaaaaaaCCaaaaaaaa
aarCCraaaaaaaaCCCaaaaaaaa
aaaaaaaaaaaaaaaaaaaaaaaaa
"}
