"a" = (/turf/variableTurf/wall,/area/allowGenerate)
"c" = (/obj/burning_barrel,/turf/variableTurf/floor,/area/noGenerate)
"j" = (/obj/item/reagent_containers/food/snacks/garlicbread,/turf/variableTurf/floor,/area/noGenerate)
"x" = (/turf/variableTurf/floor,/area/allowGenerate)
"M" = (/turf/variableTurf/floor,/area/noGenerate)

(1,1,1) = {"
aaaaxxaaaa
aaaaMMaaaa
aaaMMMMaaa
aaMMMMMMaa
aMMMMMMMMa
xMMMcjMMMx
xMMMMMMMMx
aMMMMMMMMa
aaMMMMMMaa
aaaaaaaaaa
"}
