//MAP CONVERTED BY dmm2tgm.py THIS HEADER COMMENT PREVENTS RECONVERSION, DO NOT REMOVE
"a" = (
/turf/space,
/area/allowGenerate/caves)
"c" = (
/obj/landmark/artifact,
/turf/floor/plating/gehenna,
/area/noGenerate)
"F" = (
/obj/random_item_spawner/landmine,
/turf/floor/plating/gehenna,
/area/noGenerate)
"N" = (
/turf/floor/plating/gehenna,
/area/noGenerate)

(1,1,1) = {"
a
a
a
a
a
"}
(2,1,1) = {"
a
a
N
a
a
"}
(3,1,1) = {"
a
N
F
c
a
"}
(4,1,1) = {"
a
a
N
a
a
"}
(5,1,1) = {"
a
a
a
a
a
"}
