//MAP CONVERTED BY dmm2tgm.py THIS HEADER COMMENT PREVENTS RECONVERSION, DO NOT REMOVE
"a" = (
/turf/space,
/area/space)
"j" = (
/turf/variableTurf/wall,
/area/space)
"s" = (
/obj/critter/rockworm,
/turf/floor/sand,
/area/space)
"y" = (
/turf/floor/sand,
/area/space)

(1,1,1) = {"
a
a
a
a
a
y
y
a
a
a
"}
(2,1,1) = {"
a
a
a
a
j
y
y
j
a
a
"}
(3,1,1) = {"
a
a
a
j
y
y
y
y
j
a
"}
(4,1,1) = {"
a
a
a
y
y
j
y
y
y
a
"}
(5,1,1) = {"
a
a
a
y
y
j
y
j
y
a
"}
(6,1,1) = {"
a
a
a
y
j
s
y
j
y
a
"}
(7,1,1) = {"
a
a
a
y
a
y
y
y
y
a
"}
(8,1,1) = {"
a
a
j
y
a
y
y
y
y
a
"}
(9,1,1) = {"
a
a
j
y
a
y
y
y
y
a
"}
(10,1,1) = {"
a
a
y
y
y
y
y
j
y
a
"}
(11,1,1) = {"
a
a
y
j
s
y
y
a
y
a
"}
(12,1,1) = {"
a
a
y
j
y
y
y
s
y
a
"}
(13,1,1) = {"
a
a
y
y
y
y
a
y
j
a
"}
(14,1,1) = {"
a
a
y
j
y
a
s
y
a
a
"}
(15,1,1) = {"
a
a
y
a
y
a
y
y
a
a
"}
(16,1,1) = {"
a
a
y
s
y
y
y
y
a
a
"}
(17,1,1) = {"
a
a
y
j
y
j
y
y
a
a
"}
(18,1,1) = {"
a
a
y
j
y
j
y
y
j
a
"}
(19,1,1) = {"
a
a
y
a
y
s
y
y
j
a
"}
(20,1,1) = {"
a
j
y
j
y
j
y
y
j
a
"}
(21,1,1) = {"
a
j
y
y
y
j
y
y
j
a
"}
(22,1,1) = {"
a
a
j
y
y
a
y
y
j
a
"}
(23,1,1) = {"
a
a
a
y
y
y
y
j
a
a
"}
(24,1,1) = {"
a
a
a
y
y
a
a
a
a
a
"}
(25,1,1) = {"
a
a
a
y
y
a
a
a
a
a
"}
