//MAP CONVERTED BY dmm2tgm.py THIS HEADER COMMENT PREVENTS RECONVERSION, DO NOT REMOVE
"a" = (
/turf/space,
/area/space)
"d" = (
/obj/decal/mushrooms/type2,
/turf/floor/sand,
/area/space)
"f" = (
/obj/decal/mushrooms/type5,
/turf/floor/sand,
/area/space)
"p" = (
/turf/floor/sand,
/area/space)
"q" = (
/obj/decal/mushrooms/type1,
/turf/floor/sand,
/area/space)
"u" = (
/obj/critter/spirit,
/turf/floor/sand,
/area/space)
"F" = (
/obj/decal/mushrooms/type4,
/turf/floor/sand,
/area/space)
"N" = (
/obj/decal/mushrooms/type6,
/turf/floor/sand,
/area/space)
"X" = (
/obj/item/device/light/glowstick/green_on,
/turf/floor/sand,
/area/space)
"Y" = (
/obj/decal/mushrooms/type3,
/turf/floor/sand,
/area/space)

(1,1,1) = {"
a
a
a
a
a
a
a
p
p
q
a
a
a
a
a
a
a
a
a
a
a
a
a
a
a
"}
(2,1,1) = {"
a
a
a
a
a
a
f
p
p
p
F
a
a
a
a
a
a
a
a
a
a
a
a
a
a
"}
(3,1,1) = {"
a
a
a
a
a
p
p
p
X
p
p
p
p
a
a
a
a
a
a
a
a
a
p
a
a
"}
(4,1,1) = {"
a
a
f
p
p
p
p
p
p
p
p
p
p
p
f
a
a
a
a
a
a
Y
p
p
a
"}
(5,1,1) = {"
a
p
p
p
p
p
p
p
p
p
p
p
p
p
p
p
p
N
p
p
p
p
p
p
p
"}
(6,1,1) = {"
p
p
p
p
p
N
a
a
a
a
d
p
p
p
p
p
p
p
p
p
p
p
p
p
a
"}
(7,1,1) = {"
p
p
p
p
a
a
a
a
a
a
a
a
p
p
p
p
u
p
p
p
p
p
F
a
a
"}
(8,1,1) = {"
a
N
a
a
a
a
a
a
a
a
a
a
a
a
d
p
p
p
p
d
a
a
a
a
a
"}
(9,1,1) = {"
a
a
a
a
a
a
a
a
a
a
a
a
a
a
a
p
p
p
p
a
a
a
a
a
a
"}
(10,1,1) = {"
a
a
a
a
a
a
a
a
a
a
a
a
a
a
a
a
p
p
a
a
a
a
a
a
a
"}
