//MAP CONVERTED BY dmm2tgm.py THIS HEADER COMMENT PREVENTS RECONVERSION, DO NOT REMOVE
"a" = (
/obj/decal/skeleton/decomposed_corpse,
/obj/item/clothing/head/cowboy{
	pixel_x = 8;
	pixel_y = 7
	},
/obj/decal/cleanable/tracked_reagents/blood/splatter,
/obj/item/gun/modular/italian/revolver/basic,
/turf/floor/plating/gehenna,
/area/noGenerate)

(1,1,1) = {"
a
"}
