"a" = (/turf/variableTurf/wall,/area/allowGenerate)
"b" = (/turf/simulated/floor/setpieces/bloodfloor{icon_state = "bloodfloor_3"},/area/allowGenerate)
"e" = (/obj/item/reagent_containers/food/snacks/ingredient/meat/synthmeat,/turf/simulated/floor/setpieces/bloodfloor{icon_state = "bloodfloor_3"},/area/noGenerate)
"i" = (/obj/item/reagent_containers/food/snacks/ingredient/meat/mysterymeat,/turf/simulated/floor/setpieces/bloodfloor,/area/noGenerate)
"p" = (/turf/simulated/floor/setpieces/bloodfloor,/area/noGenerate)
"r" = (/obj/item/mine/gibs/armed,/turf/simulated/floor/setpieces/bloodfloor{icon_state = "bloodfloor_2"; name = "Fleshy Floor"},/area/noGenerate)
"v" = (/turf/simulated/floor/setpieces/bloodfloor{icon_state = "bloodfloor_3"},/area/noGenerate)
"C" = (/obj/item/mine/gibs/armed,/turf/simulated/floor/setpieces/bloodfloor,/area/noGenerate)
"H" = (/obj/critter/blobman/meaty_martha,/turf/simulated/floor/setpieces/bloodfloor{icon_state = "bloodfloor_3"},/area/noGenerate)
"I" = (/obj/item/mine/gibs/armed,/turf/simulated/floor/setpieces/bloodfloor{icon_state = "bloodfloor_3"},/area/noGenerate)
"M" = (/turf/simulated/floor/setpieces/bloodfloor,/area/allowGenerate)
"Q" = (/obj/item/reagent_containers/food/snacks/ingredient/meat/mysterymeat,/turf/simulated/floor/setpieces/bloodfloor{icon_state = "bloodfloor_2"; name = "Fleshy Floor"},/area/noGenerate)
"U" = (/obj/item/reagent_containers/food/snacks/ingredient/meatpaste,/turf/simulated/floor/setpieces/bloodfloor,/area/noGenerate)
"W" = (/obj/item/reagent_containers/food/snacks/ingredient/meatpaste,/turf/simulated/floor/setpieces/bloodfloor{icon_state = "bloodfloor_2"; name = "Fleshy Floor"},/area/noGenerate)
"X" = (/turf/simulated/floor/setpieces/bloodfloor{icon_state = "bloodfloor_2"; name = "Fleshy Floor"},/area/noGenerate)

(1,1,1) = {"
aaaaaaaMba
aaaaaaIvpa
aaaavHpXXa
aaIvCXQpIa
avvpXWpvaa
bviWXpvIaa
MCXrpeIaaa
avXUvaaaaa
aaCvaaaaaa
aaaaaaaaaa
"}
