//MAP CONVERTED BY dmm2tgm.py THIS HEADER COMMENT PREVENTS RECONVERSION, DO NOT REMOVE
"a" = (
/turf/variableTurf/wall,
/area/allowGenerate)
"g" = (
/obj/landmark/artifact,
/turf/floor/plating/gehenna,
/area/noGenerate)
"l" = (
/obj/reagent_dispensers/cleanable/spiders,
/turf/floor/plating/gehenna,
/area/noGenerate)
"n" = (
/mob/living/critter/spider/nice,
/turf/floor/plating/gehenna,
/area/noGenerate)
"o" = (
/mob/living/critter/spider/baby{
	ai_type = "/datum/aiHolder/wanderer"
	},
/turf/floor/plating/gehenna,
/area/noGenerate)
"q" = (
/obj/decal/cleanable/cobwebFloor,
/turf/variableTurf/wall,
/area/allowGenerate)
"r" = (
/turf/space,
/area/allowGenerate)
"t" = (
/obj/decal/cleanable/cobwebFloor,
/turf/variableTurf/wall,
/area/noGenerate)
"u" = (
/mob/living/critter/spider/med{
	ai_type = "/datum/aiHolder/wanderer"
	},
/turf/floor/plating/gehenna,
/area/noGenerate)
"v" = (
/turf/variableTurf/wall,
/area/noGenerate)
"Q" = (
/mob/living/critter/spider/spacerachnid{
	ai_type = "/datum/aiHolder/violent";
	venom1 = "toxin";
	venom2 = "histamine"
	},
/turf/floor/plating/gehenna,
/area/noGenerate)
"T" = (
/mob/living/critter/spider{
	ai_type = "/datum/aiHolder/violent";
	venom1 = "toxin"
	},
/turf/floor/plating/gehenna,
/area/noGenerate)
"U" = (
/turf/floor/plating/gehenna,
/area/noGenerate)

(1,1,1) = {"
r
r
a
a
q
q
a
a
r
r
"}
(2,1,1) = {"
r
q
a
t
u
U
l
a
a
r
"}
(3,1,1) = {"
a
a
o
v
v
U
U
U
a
a
"}
(4,1,1) = {"
q
v
U
v
t
v
Q
U
o
a
"}
(5,1,1) = {"
a
U
U
n
U
v
U
U
l
a
"}
(6,1,1) = {"
a
U
U
U
l
g
U
U
U
q
"}
(7,1,1) = {"
a
U
U
v
U
o
U
v
T
q
"}
(8,1,1) = {"
a
a
v
v
U
U
U
v
a
a
"}
(9,1,1) = {"
r
a
q
U
U
u
U
a
q
r
"}
(10,1,1) = {"
r
r
a
a
a
a
q
a
r
r
"}
