//MAP CONVERTED BY dmm2tgm.py THIS HEADER COMMENT PREVENTS RECONVERSION, DO NOT REMOVE
"a" = (
/turf/variableTurf/wall,
/area/allowGenerate)
"b" = (
/turf/floor/setpieces/bloodfloor{
	icon_state = "bloodfloor_3"
	},
/area/allowGenerate)
"e" = (
/obj/item/reagent_containers/food/snacks/ingredient/meat/synthmeat,
/turf/floor/setpieces/bloodfloor{
	icon_state = "bloodfloor_3"
	},
/area/noGenerate)
"i" = (
/obj/item/reagent_containers/food/snacks/ingredient/meat/mysterymeat,
/turf/floor/setpieces/bloodfloor,
/area/noGenerate)
"p" = (
/turf/floor/setpieces/bloodfloor,
/area/noGenerate)
"r" = (
/obj/item/mine/gibs/armed,
/turf/floor/setpieces/bloodfloor{
	icon_state = "bloodfloor_2";
	name = "Fleshy Floor"
	},
/area/noGenerate)
"v" = (
/turf/floor/setpieces/bloodfloor{
	icon_state = "bloodfloor_3"
	},
/area/noGenerate)
"C" = (
/obj/item/mine/gibs/armed,
/turf/floor/setpieces/bloodfloor,
/area/noGenerate)
"H" = (
/obj/critter/blobman/meaty_martha,
/turf/floor/setpieces/bloodfloor{
	icon_state = "bloodfloor_3"
	},
/area/noGenerate)
"I" = (
/obj/item/mine/gibs/armed,
/turf/floor/setpieces/bloodfloor{
	icon_state = "bloodfloor_3"
	},
/area/noGenerate)
"M" = (
/turf/floor/setpieces/bloodfloor,
/area/allowGenerate)
"Q" = (
/obj/item/reagent_containers/food/snacks/ingredient/meat/mysterymeat,
/turf/floor/setpieces/bloodfloor{
	icon_state = "bloodfloor_2";
	name = "Fleshy Floor"
	},
/area/noGenerate)
"U" = (
/obj/item/reagent_containers/food/snacks/ingredient/meatpaste,
/turf/floor/setpieces/bloodfloor,
/area/noGenerate)
"W" = (
/obj/item/reagent_containers/food/snacks/ingredient/meatpaste,
/turf/floor/setpieces/bloodfloor{
	icon_state = "bloodfloor_2";
	name = "Fleshy Floor"
	},
/area/noGenerate)
"X" = (
/turf/floor/setpieces/bloodfloor{
	icon_state = "bloodfloor_2";
	name = "Fleshy Floor"
	},
/area/noGenerate)

(1,1,1) = {"
a
a
a
a
a
b
M
a
a
a
"}
(2,1,1) = {"
a
a
a
a
v
v
C
v
a
a
"}
(3,1,1) = {"
a
a
a
I
v
i
X
X
C
a
"}
(4,1,1) = {"
a
a
a
v
p
W
r
U
v
a
"}
(5,1,1) = {"
a
a
v
C
X
X
p
v
a
a
"}
(6,1,1) = {"
a
a
H
X
W
p
e
a
a
a
"}
(7,1,1) = {"
a
I
p
Q
p
v
I
a
a
a
"}
(8,1,1) = {"
M
v
X
p
v
I
a
a
a
a
"}
(9,1,1) = {"
b
p
X
I
a
a
a
a
a
a
"}
(10,1,1) = {"
a
a
a
a
a
a
a
a
a
a
"}
