"a" = (/turf/space,/area/space)
"j" = (/turf/variableTurf/wall,/area/space)
"s" = (/obj/critter/rockworm,/turf/simulated/floor/sand,/area/space)
"y" = (/turf/simulated/floor/sand,/area/space)

(1,1,1) = {"
aaaaaaaaaaaaaaaaaaaaaaaaa
aaaaaaaaaaaaaaaaaaajjaaaa
aaaaaaajjyyyyyyyyyyyyjaaa
aajyyyyyyyjjyjasjjajyyyyy
ajyyyjaaaysyyyyyyyyyyyyyy
yyyjjsyyyyyyyaayjjsjjayaa
yyyyyyyyyyyyasyyyyyyyyyaa
ajyyjjyyyjasyyyyyyyyyyjaa
aajyyyyyyyyyjaaaajjjjjaaa
aaaaaaaaaaaaaaaaaaaaaaaaa
"}
