"a" = (/turf/space,/area/allowGenerate/caves)
"b" = (/obj/decal/cleanable/dirt/random,/turf/unsimulated/floor/grey/blackgrime/other,/area/noGenerate)
"c" = (/turf/simulated/wall/asteroid/gehenna/tough/z3,/area/allowGenerate/caves)
"d" = (/obj/storage/crate/loot_crate,/obj/decal/cleanable/dirt/random,/turf/simulated/floor/plating,/area/noGenerate)
"e" = (/obj/decal/cleanable/dirt/random,/obj/decal/skeleton,/obj/item/screwdriver,/turf/simulated/floor/plating,/area/noGenerate)
"g" = (/turf/simulated/floor/stairs/wide{dir = 1},/area/noGenerate)
"h" = (/obj/decal/cleanable/dirt/random,/turf/simulated/floor/plating,/area/noGenerate)
"i" = (/obj/machinery/light/fluorescent/cool/very,/obj/decal/cleanable/dirt/random,/obj/storage/crate/loot,/turf/simulated/floor/plating,/area/noGenerate)
"l" = (/obj/decal/cleanable/dirt/random,/obj/item/furniture_parts/table/regal,/turf/simulated/floor/plating,/area/noGenerate)
"m" = (/obj/machinery/door/airlock/gannets/maintenance,/obj/access_spawn/syndie_shuttle,/turf/simulated/floor,/area/noGenerate)
"n" = (/obj/machinery/light/small/reddish,/turf/simulated/floor/plating/gehenna,/area/noGenerate)
"o" = (/obj/machinery/light/fluorescent/cool/very{dir = 1},/obj/decal/cleanable/dirt/random,/obj/storage/crate/trench_loot,/turf/simulated/floor,/area/noGenerate)
"p" = (/turf/simulated/wall,/area/noGenerate)
"q" = (/turf/simulated/floor/plating/gehenna,/area/allowGenerate/caves)
"s" = (/obj/decal/cleanable/dirt/random,/obj/storage/crate/loot,/turf/simulated/floor,/area/noGenerate)
"u" = (/turf/simulated/floor/stairs/wide/other,/area/noGenerate)
"v" = (/obj/decal/cleanable/dirt/random,/obj/table/folding,/turf/simulated/floor/plating,/area/noGenerate)
"w" = (/obj/machinery/light/fluorescent/cool/very,/obj/decal/cleanable/dirt/random,/turf/simulated/floor/plating,/area/noGenerate)
"x" = (/obj/item/raw_material/scrap_metal,/obj/decal/cleanable/dirt/random,/turf/simulated/floor,/area/noGenerate)
"y" = (/obj/machinery/door/airlock/gannets/maintenance,/obj/access_spawn/security,/turf/simulated/floor,/area/noGenerate)
"z" = (/turf/simulated/floor/plating/gehenna,/area/noGenerate)
"A" = (/obj/machinery/light/small/reddish{dir = 1},/turf/simulated/floor/plating/gehenna,/area/noGenerate)
"B" = (/obj/decal/cleanable/dirt/random,/turf/unsimulated/floor/grey/blackgrime,/area/noGenerate)
"E" = (/turf/simulated/floor/stairs/wide/other{dir = 1},/area/noGenerate)
"G" = (/obj/wingrille_spawn/bulletproof,/turf/simulated/floor/plating,/area/noGenerate)
"I" = (/turf/simulated/floor/stairs/wide,/area/noGenerate)
"J" = (/obj/machinery/light/fluorescent/cool/very{dir = 1},/obj/decal/cleanable/dirt/random,/obj/storage/crate/loot,/turf/simulated/floor,/area/noGenerate)
"N" = (/obj/decal/cleanable/dirt/random,/obj/storage/crate/trench_loot,/turf/simulated/floor,/area/noGenerate)
"O" = (/obj/storage/crate/furnacefuel,/obj/decal/cleanable/dirt/random,/turf/simulated/floor,/area/noGenerate)
"Q" = (/obj/storage/crate/loot_crate,/turf/simulated/floor/plating,/area/noGenerate)
"R" = (/obj/item/scrap,/obj/decal/cleanable/dirt/random,/turf/simulated/floor,/area/noGenerate)
"S" = (/obj/storage/crate/trench_loot/ore2,/obj/decal/cleanable/dirt/random,/turf/simulated/floor,/area/noGenerate)
"T" = (/obj/decal/cleanable/dirt/random,/turf/simulated/floor,/area/noGenerate)
"V" = (/turf/simulated/wall/asteroid/gehenna/tough/z3,/area/noGenerate)
"Y" = (/turf/space,/area/noGenerate)

(1,1,1) = {"
aaaaaaaaaaaaaaaaacccccccccccqq
aaaaaaaaaaaaaacccccccccccqqqqq
aaaaaaaaaaccccccccccccqqqqqqcc
aaaaaaaaacccccccccccqqqqqqcccc
aaaaaaaaccccccccccqqqqqqcccccc
aaaaaaacccccccqqqqqqqqccccccca
aaaaaVVVVVVzzzzzzzzzzVVccccaaa
cccaaVVVpVnzpzzpznzpVVVccccaaa
cccccVVVpppppEgpppppVVVcccaaaa
qccccVpppsoNpbBpsJSpppVccaaaaa
qccccVVpxTTTGBbGRTeOpVVccaaaaa
qqcccVVphhRTybBmThROpVVccaaaaa
qqqqcVVpvhhTGBbGTxTOpVVccaaaaa
cqqqcVpppdiQpbBphwlpppVccaaaaa
ccqqqzzzpppppIupppppVVVccaaaaa
cccqqzzzpzAzpzzpzAzpVVVcaaaaaa
cccaaYzzzzzzzzzzzzzVVVVcaaaaaa
ccaaaaaaqqqqqqqqqqqccccaaaaaaa
caaaaaaaaaaaqqqqcccccccaaaaaaa
aaaaaaaaaaaaaqqcccccccaaaaaaaa
"}
