"a" = (/turf/space,/area/space)
"g" = (/turf/wall/asteroid/gehenna/tough/z3,/area/noGenerate)
"F" = (/obj/random_item_spawner/landmine,/turf/floor/plating/gehenna,/area/noGenerate)
"N" = (/turf/floor/plating/gehenna,/area/noGenerate)

(1,1,1) = {"
aagga
aNNgg
gNFNg
ggNNa
aggaa
"}
