//MAP CONVERTED BY dmm2tgm.py THIS HEADER COMMENT PREVENTS RECONVERSION, DO NOT REMOVE
"a" = (
/turf/space,
/area/allowGenerate/caves)
"b" = (
/turf/variableTurf/wall,
/area/noGenerate)
"k" = (
/turf/floor/plating/gehenna/plasma,
/area/noGenerate)
"P" = (
/mob/living/critter/plasmaspore,
/turf/floor/plating/gehenna/plasma,
/area/noGenerate)

(1,1,1) = {"
a
a
b
b
b
b
b
b
a
a
"}
(2,1,1) = {"
a
b
b
k
k
k
k
b
b
a
"}
(3,1,1) = {"
b
b
k
k
k
k
k
k
b
b
"}
(4,1,1) = {"
b
k
k
P
b
b
k
k
k
b
"}
(5,1,1) = {"
b
k
k
k
b
b
k
k
k
b
"}
(6,1,1) = {"
b
k
k
k
k
k
P
k
k
b
"}
(7,1,1) = {"
b
b
k
k
k
k
k
k
b
b
"}
(8,1,1) = {"
a
b
b
k
k
k
k
b
b
a
"}
(9,1,1) = {"
a
a
b
b
b
b
b
b
a
a
"}
(10,1,1) = {"
a
a
a
b
b
b
b
a
a
a
"}
