"a" = (/turf/space,/area/allowGenerate/caves)
"b" = (/obj/item/raw_material/scrap_metal,/obj/decal/cleanable/dirt/random,/turf/simulated/floor,/area/noGenerate)
"d" = (/obj/decal/cleanable/dirt/random,/turf/simulated/floor,/area/noGenerate)
"f" = (/obj/storage/crate/furnacefuel,/obj/decal/cleanable/dirt/random,/turf/simulated/floor,/area/noGenerate)
"g" = (/turf/simulated/floor/stairs/wide,/area/noGenerate)
"h" = (/turf/simulated/floor/stairs/wide{dir = 1},/area/noGenerate)
"j" = (/turf/simulated/floor/stairs/wide/other{dir = 1},/area/noGenerate)
"k" = (/obj/decal/cleanable/dirt/random,/turf/unsimulated/floor/grey/blackgrime/other,/area/noGenerate)
"m" = (/obj/decal/cleanable/dirt/random,/obj/decal/skeleton,/obj/item/screwdriver,/turf/simulated/floor/plating,/area/noGenerate)
"n" = (/obj/wingrille_spawn/hardened,/turf/simulated/floor/plating,/area/noGenerate)
"r" = (/obj/machinery/light/fluorescent/cool/very{dir = 1},/obj/storage/crate/loot_crate,/obj/decal/cleanable/dirt/random,/turf/simulated/floor,/area/noGenerate)
"s" = (/obj/decal/cleanable/dirt/random,/turf/simulated/floor/plating,/area/noGenerate)
"v" = (/turf/variableTurf/wall,/area/allowGenerate/caves)
"w" = (/obj/item/scrap,/obj/decal/cleanable/dirt/random,/turf/simulated/floor,/area/noGenerate)
"x" = (/obj/storage/crate/trench_loot/ore2,/obj/decal/cleanable/dirt/random,/turf/simulated/floor,/area/noGenerate)
"y" = (/obj/decal/cleanable/dirt/random,/obj/item/furniture_parts/table/regal,/turf/simulated/floor/plating,/area/noGenerate)
"z" = (/obj/machinery/light/small/reddish,/turf/variableTurf/floor,/area/noGenerate)
"C" = (/obj/decal/cleanable/dirt/random,/obj/table/folding,/turf/simulated/floor/plating,/area/noGenerate)
"D" = (/obj/decal/cleanable/dirt/random,/turf/unsimulated/floor/grey/blackgrime,/area/noGenerate)
"F" = (/turf/variableTurf/floor,/area/allowGenerate/caves)
"G" = (/obj/machinery/light/fluorescent/cool/very{dir = 1},/obj/storage/crate/trench_loot/ore3,/obj/decal/cleanable/dirt/random,/turf/simulated/floor,/area/noGenerate)
"J" = (/obj/machinery/light/fluorescent/cool/very,/obj/decal/cleanable/dirt/random,/turf/simulated/floor/plating,/area/noGenerate)
"L" = (/obj/storage/crate/loot_crate,/obj/decal/cleanable/dirt/random,/turf/simulated/floor/plating,/area/noGenerate)
"M" = (/obj/machinery/light/fluorescent/cool/very,/obj/storage/crate/loot_crate,/obj/decal/cleanable/dirt/random,/turf/simulated/floor/plating,/area/noGenerate)
"N" = (/obj/storage/crate/trench_loot/ore4,/obj/decal/cleanable/dirt/random,/turf/simulated/floor,/area/noGenerate)
"Q" = (/turf/variableTurf/floor,/area/noGenerate)
"R" = (/turf/simulated/floor/stairs/wide/other,/area/noGenerate)
"S" = (/turf/simulated/wall,/area/noGenerate)
"T" = (/obj/storage/crate/loot_crate,/obj/decal/cleanable/dirt/random,/turf/simulated/floor,/area/noGenerate)
"V" = (/turf/variableTurf/wall,/area/noGenerate)
"W" = (/obj/machinery/light/small/reddish{dir = 1},/turf/variableTurf/floor,/area/noGenerate)
"Y" = (/turf/space,/area/noGenerate)
"Z" = (/obj/machinery/door/airlock/gannets/maintenance,/turf/simulated/floor,/area/noGenerate)

(1,1,1) = {"
aaaaaaaaaaaaaaaaavvvvvvvvvvvFF
aaaaaaaaaaaaaavvvvvvvvvvvFFFFF
aaaaaaaaaavvvvvvvvvvvvFFFFFFvv
aaaaaaaaavvvvvvvvvvvFFFFFFvvvv
aaaaaaaavvvvvvvvvvFFFFFFvvvvvv
aaaaaaavvvvvvvFFFFFFFFvvvvvvva
aaaaaVVVVVVQQQQQQQQQQVVvvvvaaa
vvvaaVVVSVzQSQQSQzQSVVVvvvvaaa
vvvvvVVVSSSSSjhSSSSSVVVvvvaaaa
FvvvvVSSSTrTSkDSNGxSSSVvvaaaaa
FvvvvVVSbdddnDknwdmfSVVvvaaaaa
FFvvvVVSsswdZkDZdswfSVVvvaaaaa
FFFFvVVSCssdnDkndbdfSVVvvaaaaa
vFFFvVSSSLMLSkDSsJySSSVvvaaaaa
vvFFFQQQSSSSSgRSSSSSVVVvvaaaaa
vvvFFQQQSQWQSQQSQWQSVVVvaaaaaa
vvvaaYQQQQQQQQQQQQQVVVVvaaaaaa
vvaaaaaaFFFFFFFFFFFvvvvaaaaaaa
vaaaaaaaaaaaFFFFvvvvvvvaaaaaaa
aaaaaaaaaaaaaFFvvvvvvvaaaaaaaa
"}
