"a" = (/turf/space,/area/space)
"b" = (/turf/simulated/floor/plating{icon_state = "panelscorched"},/area/noGenerate)
"c" = (/obj/decal/cleanable/mud/drip/low,/turf/simulated/floor/gehenna/farts,/area/noGenerate)
"d" = (/obj/critter/spirit,/turf/simulated/floor/gehenna/farts,/area/noGenerate)
"f" = (/mob/living/critter/plasmaspore,/turf/simulated/floor/gehenna/plasma,/area/noGenerate)
"g" = (/obj/lattice{dir = 4; icon_state = "lattice-dir"},/turf/simulated/floor/plating{icon_state = "platingdmg1"},/area/noGenerate)
"h" = (/turf/simulated/floor/gehenna,/area/noGenerate)
"i" = (/obj/item/raw_material/shard/glass,/turf/simulated/floor/damaged5,/area/noGenerate)
"k" = (/obj/item/tile/steel{pixel_x = -3; pixel_y = -5},/turf/simulated/floor/gehenna/farts,/area/noGenerate)
"l" = (/obj/fluid_spawner/polluted_filth,/turf/simulated/floor/gehenna/farts,/area/noGenerate)
"n" = (/turf/simulated/floor/scorched2,/area/noGenerate)
"p" = (/obj/lattice,/turf/simulated/floor/gehenna,/area/noGenerate)
"q" = (/obj/item/raw_material/plasmastone,/turf/simulated/floor/gehenna/plasma,/area/noGenerate)
"t" = (/turf/simulated/wall/asteroid/gehenna/z3/tough,/area/space)
"u" = (/turf/simulated/floor/damaged5,/area/noGenerate)
"v" = (/obj/item/tile/steel{pixel_x = -3; pixel_y = -5},/turf/simulated/floor/gehenna,/area/noGenerate)
"w" = (/obj/critter/rockworm,/turf/simulated/floor/gehenna,/area/noGenerate)
"y" = (/obj/item/raw_material/shard/glass,/turf/simulated/floor/gehenna,/area/noGenerate)
"A" = (/turf/simulated/floor/gehenna/farts,/area/noGenerate)
"C" = (/obj/decal/cleanable/mud/drip/low,/turf/simulated/floor/gehenna,/area/noGenerate)
"D" = (/turf/simulated/wall/r_wall,/area/noGenerate)
"F" = (/obj/item/raw_material/shard/glass,/turf/simulated/floor/scorched2,/area/noGenerate)
"J" = (/obj/item/raw_material/shard/glass,/turf/simulated/floor/plating{icon_state = "platingdmg1"},/area/noGenerate)
"L" = (/obj/critter/spirit,/turf/simulated/floor/gehenna/plasma,/area/noGenerate)
"M" = (/obj/lattice{icon_state = "lattice-dir"},/turf/simulated/floor/plating{icon_state = "platingdmg3"},/area/noGenerate)
"P" = (/turf/simulated/floor/gehenna/plasma,/area/noGenerate)
"Q" = (/turf/simulated/wall/asteroid/gehenna/z3/tough,/area/noGenerate)
"S" = (/turf/simulated/wall,/area/noGenerate)
"V" = (/obj/lattice,/turf/simulated/floor/plating{icon_state = "panelscorched"},/area/noGenerate)
"Z" = (/turf/simulated/floor/gehenna,/area/space)

(1,1,1) = {"
ZZDaaaaaaaaaaaaQQQQaaaaaaaaaaaQQQQQ
ZZhhhDaaaaaaaaQQfPQQaaQQQQaaDQQAAAQ
aZhhhhDaaaaShSQPPPPQQQQfPQaaQQAAAAQ
aahhhhhhaaSpQQQQPPPPPPPPPQDQQDAAAQQ
ttSShhhhhhQwhQQQQQQqPLPPQQQQAlAAQQa
tttSahhFhhhhhQhQQQQQQPPQQQDkAAQQQaa
atttaaaSShhhhvQhhbQQQQQQQAAAAQQaaaa
aZtZaaaaaaaSShhhhhbuQQQQQAcQQQaaaaa
aZttDDaaQQQQQuJhhhQCvnViQQQQQQaaaaa
aaZZttDaAAAAQQQgJMyhhhhhChhQQSSaaaa
aaaZZtttSSkAAAQQQnSahhhhhQhhhhSaaaa
aaaaZZZtQSSAAdAQQQSSSaQQvhwhhhhZaaa
aaaaaaZZttttAAAAAQQQaaDQQQQhhhhZZZa
aaaaaaaaZZattttAAAQQaaaaaDQDDZZZZZZ
aaaaaaaaaaaattttaaaaaaaaaaaaaaaaZZZ
"}
