//MAP CONVERTED BY dmm2tgm.py THIS HEADER COMMENT PREVENTS RECONVERSION, DO NOT REMOVE
"a" = (
/turf/space,
/area/allowGenerate/caves)
"p" = (
/obj/random_item_spawner/landmine,
/turf/floor/plating/gehenna,
/area/noGenerate)
"R" = (
/turf/floor/plating/gehenna,
/area/noGenerate)

(1,1,1) = {"
a
a
a
a
a
a
a
"}
(2,1,1) = {"
R
R
a
a
a
a
a
"}
(3,1,1) = {"
a
R
p
R
a
a
a
"}
(4,1,1) = {"
a
a
R
R
R
a
a
"}
(5,1,1) = {"
a
a
a
R
p
R
a
"}
(6,1,1) = {"
a
a
a
a
a
R
R
"}
(7,1,1) = {"
a
a
a
a
a
a
R
"}
