//MAP CONVERTED BY dmm2tgm.py THIS HEADER COMMENT PREVENTS RECONVERSION, DO NOT REMOVE
"a" = (
/turf/space,
/area/allowGenerate)
"e" = (
/obj/item/reagent_containers/food/snacks/ingredient/meat/grubmeat,
/turf/floor/setpieces/bloodfloor{
	icon_state = "bloodfloor_3"
	},
/area/noGenerate)
"i" = (
/obj/item/reagent_containers/food/snacks/ingredient/meat/mysterymeat,
/turf/floor/setpieces/bloodfloor,
/area/noGenerate)
"m" = (
/obj/crevice/meatland,
/turf/floor/setpieces/bloodfloor,
/area/noGenerate)
"p" = (
/turf/floor/setpieces/bloodfloor,
/area/noGenerate)
"r" = (
/obj/item/mine/gibs/armed,
/turf/floor/setpieces/bloodfloor{
	icon_state = "bloodfloor_2";
	name = "Fleshy Floor"
	},
/area/noGenerate)
"v" = (
/turf/floor/setpieces/bloodfloor{
	icon_state = "bloodfloor_3"
	},
/area/noGenerate)
"C" = (
/obj/item/mine/gibs/armed,
/turf/floor/setpieces/bloodfloor,
/area/noGenerate)
"D" = (
/mob/living/critter/changeling/headspider{
	ai_type = "/datum/aiHolder/violent";
	is_npc = 1;
	icon_state = "meaty_mouth";
	icon_state_dead = "meaty_mouth";
	name = "greasy polyp"
	},
/turf/floor/setpieces/bloodfloor{
	icon_state = "bloodfloor_2";
	name = "Fleshy Floor"
	},
/area/noGenerate)
"I" = (
/obj/item/mine/gibs/armed,
/turf/floor/setpieces/bloodfloor{
	icon_state = "bloodfloor_3"
	},
/area/noGenerate)
"Q" = (
/obj/item/reagent_containers/food/snacks/ingredient/meat/mysterymeat,
/turf/floor/setpieces/bloodfloor{
	icon_state = "bloodfloor_2";
	name = "Fleshy Floor"
	},
/area/noGenerate)
"U" = (
/obj/item/reagent_containers/food/snacks/ingredient/meatpaste,
/turf/floor/setpieces/bloodfloor,
/area/noGenerate)
"W" = (
/obj/item/reagent_containers/food/snacks/ingredient/meatpaste,
/turf/floor/setpieces/bloodfloor{
	icon_state = "bloodfloor_2";
	name = "Fleshy Floor"
	},
/area/noGenerate)
"X" = (
/turf/floor/setpieces/bloodfloor{
	icon_state = "bloodfloor_2";
	name = "Fleshy Floor"
	},
/area/noGenerate)

(1,1,1) = {"
a
a
a
a
a
a
a
a
a
a
"}
(2,1,1) = {"
a
a
a
a
v
v
C
v
a
a
"}
(3,1,1) = {"
a
a
a
I
v
i
X
X
C
a
"}
(4,1,1) = {"
a
a
a
v
p
W
r
U
v
a
"}
(5,1,1) = {"
a
a
v
C
X
D
p
v
a
a
"}
(6,1,1) = {"
a
a
v
X
W
p
e
a
a
a
"}
(7,1,1) = {"
a
I
p
Q
m
v
I
a
a
a
"}
(8,1,1) = {"
a
v
X
p
v
I
a
a
a
a
"}
(9,1,1) = {"
a
p
X
I
a
a
a
a
a
a
"}
(10,1,1) = {"
a
a
a
a
a
a
a
a
a
a
"}
