//MAP CONVERTED BY dmm2tgm.py THIS HEADER COMMENT PREVENTS RECONVERSION, DO NOT REMOVE
"a" = (
/turf/space,
/area/allowGenerate/caves)
"j" = (
/turf/variableTurf/wall,
/area/noGenerate)
"s" = (
/obj/critter/rockworm,
/turf/floor/sand,
/area/noGenerate)
"y" = (
/turf/floor/sand,
/area/noGenerate)

(1,1,1) = {"
a
a
a
a
a
y
y
a
a
a
"}
(2,1,1) = {"
a
a
a
a
j
y
y
a
a
a
"}
(3,1,1) = {"
a
a
a
j
y
y
y
a
a
a
"}
(4,1,1) = {"
a
a
a
y
y
j
y
y
a
a
"}
(5,1,1) = {"
a
a
a
y
y
j
y
j
a
a
"}
(6,1,1) = {"
a
a
a
y
j
s
y
j
a
a
"}
(7,1,1) = {"
a
a
a
y
a
y
y
y
a
a
"}
(8,1,1) = {"
a
a
j
y
a
a
y
y
y
a
"}
(9,1,1) = {"
a
a
j
y
a
a
a
y
y
a
"}
(10,1,1) = {"
a
a
y
y
y
a
a
j
y
a
"}
(11,1,1) = {"
a
a
y
j
s
a
a
a
y
a
"}
(12,1,1) = {"
a
a
a
j
j
y
a
s
y
a
"}
(13,1,1) = {"
a
a
a
y
j
y
a
y
j
a
"}
(14,1,1) = {"
a
a
a
j
j
j
s
y
a
a
"}
(15,1,1) = {"
a
a
a
a
j
j
y
y
a
a
"}
(16,1,1) = {"
a
a
a
s
y
j
y
y
a
a
"}
(17,1,1) = {"
a
a
y
y
y
j
y
y
a
a
"}
(18,1,1) = {"
a
a
y
j
j
j
y
y
j
a
"}
(19,1,1) = {"
a
a
y
a
j
s
y
j
j
a
"}
(20,1,1) = {"
a
j
y
j
y
y
j
j
j
a
"}
(21,1,1) = {"
a
j
j
y
y
j
j
j
a
a
"}
(22,1,1) = {"
a
a
j
y
y
a
j
y
a
a
"}
(23,1,1) = {"
a
a
a
y
y
j
j
a
a
a
"}
(24,1,1) = {"
a
a
a
y
y
a
a
a
a
a
"}
(25,1,1) = {"
a
a
a
y
y
a
a
a
a
a
"}
