"a" = (/turf/space,/area/allowGenerate/caves)
"b" = (/mob/living/critter/small_animal/meatslinky/pine_marten/farten,/turf/floor/plating/gehenna/farts,/area/noGenerate)
"i" = (/turf/variableTurf/wall,/area/noGenerate)
"s" = (/turf/floor/plating/gehenna/farts,/area/noGenerate)
"O" = (/obj/item/material_piece/fart,/turf/floor/plating/gehenna/farts,/area/noGenerate)

(1,1,1) = {"
aaiiiiaaaa
aaiOsiiaaa
aiisssiiia
aiOsssssii
iisssbsssi
isssssssii
iissssOiia
aiiOssiiaa
aaiissiaaa
aaaiiiiaaa
"}
