"a" = (/turf/space,/area/allowGenerate/caves)
"b" = (/turf/variableTurf/wall,/area/noGenerate)
"k" = (/turf/simulated/floor/gehenna/plasma,/area/noGenerate)
"P" = (/mob/living/critter/plasmaspore,/turf/simulated/floor/gehenna/plasma,/area/noGenerate)

(1,1,1) = {"
aabbbbbaaa
abbkkkbbaa
bbkkkkkbba
bkkPkkkkbb
bkkbbkkkbb
bkkbbkkkbb
bkkkkPkkbb
bbkkkkkbba
abbkkkbbaa
aabbbbbaaa
"}
