"aF" = (/obj/item/reagent_containers/food/snacks/yuckburn,/obj/decal/cleanable/dirt/random,/turf/floor/engine,/area/noGenerate)
"aK" = (/obj/decal/cleanable/dirt/random,/obj/critter/rockworm,/turf/floor/plating/gehenna,/area/noGenerate)
"cr" = (/obj/lattice,/obj/decal/cleanable/dirt/random,/obj/item/raw_material/shard/glass,/turf/floor/plating/gehenna,/area/noGenerate)
"em" = (/obj/decal/fakeobjects/apc_broken,/turf/wall/r_wall,/area/noGenerate)
"fo" = (/obj/machinery/shuttle/engine/heater{dir = 4; icon_state = "alt_heater-M"},/turf/floor/plating/gehenna,/area/noGenerate)
"fz" = (/obj/item/raw_material/shard/glass,/obj/decal/cleanable/dirt/random,/turf/floor/plating/random,/area/noGenerate)
"fV" = (/obj/lattice{dir = 6; icon_state = "lattice-dir"},/turf/floor/plating/gehenna,/area/noGenerate)
"gi" = (/obj/decal/cleanable/dirt/random,/obj/item/raw_material/shard/glass,/turf/floor/plating/gehenna,/area/noGenerate)
"iS" = (/turf/floor/plating/gehenna,/area/space)
"jd" = (/obj/lattice,/obj/decal/cleanable/dirt/random,/obj/critter/spirit,/obj/decal/cleanable/dirt/random,/turf/floor/plating/gehenna,/area/noGenerate)
"jD" = (/obj/structure/girder,/obj/lattice{dir = 6; icon_state = "lattice-dir"},/turf/floor/plating/gehenna,/area/noGenerate)
"lM" = (/turf/floor/engine,/area/noGenerate)
"mg" = (/obj/decal/cleanable/dirt/random,/turf/floor/engine,/area/noGenerate)
"mw" = (/mob/living/critter/spider/med,/turf/floor/plating/gehenna,/area/noGenerate)
"my" = (/obj/machinery/shuttle/engine/heater{dir = 4; icon_state = "alt_heater-M"},/turf/space,/area/noGenerate)
"pa" = (/turf/wall/r_wall,/area/noGenerate)
"pm" = (/obj/decal/cleanable/dirt/random,/obj/machinery/door/poddoor/blast{icon_state = "bdoorright1"},/turf/floor/plating/random,/area/noGenerate)
"qJ" = (/obj/lattice,/obj/item/raw_material/shard/glass,/turf/floor/plating/gehenna,/area/noGenerate)
"qX" = (/obj/item/reagent_containers/food/snacks/ingredient/mud,/obj/decal/cleanable/dirt/random,/turf/floor/engine,/area/noGenerate)
"rd" = (/obj/decal/fakeobjects/airmonitor_broken,/turf/wall/r_wall,/area/noGenerate)
"rL" = (/obj/decal/cleanable/dirt/random,/obj/machinery/door/poddoor/blast{icon_state = "bdoorleft1"},/turf/floor/engine,/area/noGenerate)
"sQ" = (/obj/item/reagent_containers/food/snacks/yuckburn,/turf/floor/plating/random,/area/noGenerate)
"vd" = (/obj/lattice{dir = 1; icon_state = "lattice-dir"},/obj/decal/cleanable/dirt/random,/turf/floor/plating/gehenna,/area/noGenerate)
"vU" = (/obj/lattice{dir = 8; icon_state = "lattice-dir"},/turf/floor/plating/gehenna,/area/noGenerate)
"wf" = (/obj/decal/cleanable/dirt/random,/obj/machinery/door/poddoor/blast,/turf/floor/engine,/area/noGenerate)
"yn" = (/obj/lattice{dir = 6; icon_state = "lattice-dir"},/obj/decal/cleanable/dirt/random,/obj/item/skull,/turf/floor/plating/gehenna,/area/noGenerate)
"yr" = (/turf/floor/plating/gehenna,/area/noGenerate)
"yM" = (/turf/wall/asteroid/gehenna/z3,/area/space)
"zv" = (/obj/burning_barrel,/turf/floor/plating/gehenna,/area/noGenerate)
"zX" = (/obj/lattice{dir = 8; icon_state = "lattice-dir"},/obj/decal/cleanable/dirt/random,/obj/item/raw_material/shard/glass,/turf/floor/plating/gehenna,/area/noGenerate)
"AT" = (/obj/machinery/shuttle/engine/heater{dir = 4; icon_state = "alt_heater-R"},/turf/space,/area/noGenerate)
"BQ" = (/obj/lattice{icon_state = "lattice-dir"},/obj/decal/cleanable/dirt/random,/obj/decal/cleanable/mud/drip/med,/turf/floor/plating/gehenna,/area/noGenerate)
"BR" = (/obj/decal/fakeobjects/bustedpod,/obj/decal/cleanable/dirt/random,/turf/floor/plating/gehenna,/area/noGenerate)
"Cg" = (/obj/decal/fakeobjects/lighttube_broken{dir = 4},/obj/lattice,/turf/floor/plating/random,/area/noGenerate)
"Cv" = (/obj/structure/girder,/turf/floor/plating/random,/area/noGenerate)
"CQ" = (/obj/lattice,/turf/floor/plating/random,/area/noGenerate)
"Er" = (/turf/wall/asteroid/gehenna/z3,/area/noGenerate)
"EN" = (/obj/machinery/shuttle/engine/heater{dir = 4; icon_state = "alt_heater-L"},/turf/space,/area/noGenerate)
"Gu" = (/obj/machinery/shuttle/engine/propulsion{dir = 4; icon_state = "alt_propulsion"},/turf/floor/plating/gehenna,/area/noGenerate)
"GH" = (/obj/lattice{dir = 6; icon_state = "lattice-dir"},/obj/item/raw_material/shard/glass,/turf/floor/plating/gehenna,/area/noGenerate)
"Hp" = (/obj/lattice,/turf/floor/plating/gehenna,/area/noGenerate)
"Ig" = (/turf/space,/area/space)
"Im" = (/obj/lattice,/obj/decal/cleanable/dirt/random,/turf/floor/plating/gehenna,/area/noGenerate)
"JW" = (/obj/lattice,/obj/decal/skeleton,/obj/decal/cleanable/dirt/random,/turf/floor/plating/random,/area/noGenerate)
"Lx" = (/obj/critter/rockworm,/obj/decal/cleanable/dirt/random,/turf/floor/plating/gehenna,/area/noGenerate)
"LP" = (/obj/decal/cleanable/dirt/random,/turf/floor/plating/gehenna,/area/noGenerate)
"Om" = (/obj/lattice{dir = 6; icon_state = "lattice-dir"},/obj/decal/cleanable/dirt/random,/obj/item/raw_material/shard/glass,/turf/floor/plating/gehenna,/area/noGenerate)
"Qk" = (/obj/machinery/shuttle/engine/heater{dir = 4; icon_state = "alt_heater-R"},/turf/floor/plating/gehenna,/area/noGenerate)
"QH" = (/obj/decal/poster/wallsign/fire,/turf/wall/r_wall,/area/noGenerate)
"RC" = (/obj/lattice,/obj/disposalpipe/segment/horizontal,/turf/floor/plating/gehenna,/area/noGenerate)
"To" = (/obj/item/raw_material/shard/glass,/turf/floor/plating/random,/area/noGenerate)
"TM" = (/obj/machinery/shuttle/engine/heater{dir = 4; icon_state = "alt_heater-L"},/turf/floor/plating/gehenna,/area/noGenerate)
"Uf" = (/obj/critter/rockworm,/turf/floor/plating/gehenna,/area/noGenerate)
"Vd" = (/obj/decal/fakeobjects/tallsmes,/turf/floor/plating/random,/area/noGenerate)
"Wg" = (/obj/decal/poster/wallsign/hazard_exheat,/turf/wall/r_wall,/area/noGenerate)
"Wk" = (/obj/machinery/shuttle/engine/propulsion{dir = 4; icon_state = "alt_propulsion"},/obj/decal/cleanable/dirt/random,/turf/floor/plating/gehenna,/area/noGenerate)
"Wx" = (/obj/decal/poster/wallsign/space,/turf/wall/r_wall,/area/noGenerate)
"Yw" = (/obj/structure/girder,/obj/disposalpipe/segment/horizontal,/turf/floor/plating/gehenna,/area/noGenerate)
"ZM" = (/mob/living/critter/spider,/turf/floor/plating/gehenna,/area/noGenerate)

(1,1,1) = {"
IgIgIgIgyMIgyMyMyMyMyMiSiSiSiS
IgIgyMyMyMyMyMyMiSiSiSiSiSiSiS
IgIgyMyMyMiSiSiSiSiSiSiSiSLPyM
IgyMyMyMiSiSiSiSiSiSiSiSLPyMyM
yMyMyMiSiSiSiSiSiSiSiSLPyMyMyM
yMiSiSiSiSyrzvyryrvUzXEryMyMIg
iSiSiSiSiSyryryryrcrQkGuyMIgIg
iSiSiSiSLPyryryrLPjDfoGuyMIgIg
yMLPLPyMyMLPLPyrLPemTMErIgIgIg
yMyMyMyMyMyMyryryrpaErErIgIgIg
IgyMyMyMyMyMyryryrErErErIgIgIg
IgiSImErErErLPyrLPErErBRLPIgIg
IgIgZMaKOmrdLPyrsQErErgiyMIgIg
IgIgIgToRCYwyryrqJCvErErIgIgIg
IgIgIgsQVdWxLPyryrynEryMIgIgIg
IgIgIgIgCgpaATWkyrcrEryMIgIgIg
IgIgIgIgErpamyGuLPCQEryMIgIgIg
IgIgIgpapapaENGuLPErEryMIgIgIg
IgIgIgyMyMyMErLPyrEryMyMyMIgIg
IgIgIgIgyMyMEryryrEryMyMyMyMIg
IgIgIgyMyMyMHpyryrEryMyMyMyMyM
IgIgIgyMyryryrLPLPpapayMyMiSiS
IgIgIgyMyrLPlMCQaFpmLPLPUfyriS
IgIgyMyrfVTolMjdvdwfLxLPyrmwyM
IgIgyryrGHlMmgBQJWrLEryMyMyMIg
IgIgyryrCvmgfzqXpapapayMyMIgIg
IgIgyryrpaWgpapapaQHyMyMIgIgIg
IgIgyryryryryryryryryMyMIgIgIg
IgIgIgyryryryryryryryrIgIgIgIg
IgIgIgIgIgIgIgIgyryryrIgIgIgIg
IgIgIgIgIgIgIgIgIgyryryrIgIgIg
IgIgIgIgIgIgIgIgIgyryryryrIgIg
IgIgIgIgIgIgIgIgIgIgyryryrIgIg
IgIgIgIgIgIgIgIgIgIgyryryrIgIg
IgIgIgIgIgIgIgIgIgIgyryrIgIgIg
"}
