//MAP CONVERTED BY dmm2tgm.py THIS HEADER COMMENT PREVENTS RECONVERSION, DO NOT REMOVE
"ac" = (
/turf/wall/auto/reinforced,
/area/titlescreen)
"aE" = (
/obj/stool/chair/office/orange,
/turf/floor/black,
/area/titlescreen)
"aH" = (
/obj/item/raw_material/ice/nevicata,
/turf/floor/nevicata/wastes,
/area/titlescreen)
"aL" = (
/obj/decal/cleanable/mess/sodacan,
/turf/floor/nevicata/wastes/beaten,
/area/titlescreen)
"aM" = (
/obj/wingrille_spawn/reinforced,
/obj/decal/cleanable/dirt/random,
/turf/floor/plating,
/area/titlescreen)
"aO" = (
/obj/table/folding,
/obj/item/reagent_containers/food/drinks/coffee{
	pixel_y = 9;
	pixel_x = -4
	},
/obj/item/decoration/ashtray{
	pixel_y = 4;
	pixel_x = 4
	},
/turf/floor/nevicata/wastes/plating,
/area/titlescreen)
"aT" = (
/obj/railing/cool,
/turf/floor/nevicata/wastes/beaten,
/area/titlescreen)
"co" = (
/obj/neon_sign/caviar{
	pixel_y = 37
	},
/turf/floor/nevicata/wastes/beaten,
/area/titlescreen)
"cF" = (
/obj/table/auto,
/obj/item/card_box/plain{
	pixel_y = 3;
	pixel_x = 2
	},
/obj/item/cigpacket/menthol{
	pixel_x = -8;
	pixel_y = 3
	},
/turf/floor/tangerineblack{
	dir = 1
	},
/area/titlescreen)
"cQ" = (
/obj/decal/slipmat,
/turf/floor/grime,
/area/titlescreen)
"dH" = (
/obj/burning_barrel,
/turf/floor/nevicata/wastes/plating,
/area/titlescreen)
"fk" = (
/obj/decal/cleanable/dirt/random,
/obj/item/raw_material/ice/nevicata,
/turf/floor/nevicata/wastes/plating,
/area/titlescreen)
"hv" = (
/turf/floor/wood/five,
/area/titlescreen)
"hU" = (
/obj/storage/crate/packing{
	icon_state = "woodencrate9"
	},
/turf/floor/nevicata/wastes,
/area/titlescreen)
"iy" = (
/turf/floor/nevicata/wastes/plating,
/area/titlescreen)
"iB" = (
/obj/decal/tile_edge/line/black{
	dir = 10;
	icon_state = "line2"
	},
/turf/floor/carpet/grime,
/area/titlescreen)
"kx" = (
/obj/machinery/door/airlock/gannets/glass,
/turf/floor/grime,
/area/titlescreen)
"lG" = (
/turf/wall/asteroid/nevicata,
/area/titlescreen)
"lJ" = (
/obj/table/reinforced/auto,
/obj/item/plate{
	pixel_y = 8;
	pixel_x = 1
	},
/obj/item/reagent_containers/food/snacks/condiment/syrup{
	pixel_y = 21;
	pixel_x = -6
	},
/obj/item/reagent_containers/food/snacks/pancake{
	pixel_y = 7;
	pixel_x = 1
	},
/obj/item/kitchen/utensil/fork{
	pixel_y = -4;
	pixel_x = 3;
	dir = 8
	},
/turf/floor/black,
/area/titlescreen)
"lP" = (
/obj/stool/chair/orange{
	dir = 8
	},
/turf/floor/tangerineblack{
	dir = 5
	},
/area/titlescreen)
"mH" = (
/obj/chainlink_fence,
/turf/floor/nevicata/wastes/beaten,
/area/titlescreen)
"oi" = (
/obj/decal/cleanable/mess/sodacan,
/turf/floor/wood/five,
/area/titlescreen)
"pm" = (
/obj/decal/cleanable/dirt/random,
/turf/floor/wood/five,
/area/titlescreen)
"po" = (
/obj/stool/chair/orange{
	dir = 4
	},
/obj/decal/cleanable/dirt/random,
/turf/floor/tangerineblack{
	dir = 1
	},
/area/titlescreen)
"pV" = (
/obj/machinery/door/airlock/gannets/glass,
/turf/floor/carpet/grime3,
/area/titlescreen)
"qi" = (
/obj/decal/cleanable/dirt/random,
/turf/floor/tangerineblack{
	dir = 8
	},
/area/titlescreen)
"qz" = (
/turf/wall/asteroid/nevicata/tough,
/area/titlescreen)
"rr" = (
/obj/shrub/big/big3,
/turf/floor/planter,
/area/titlescreen)
"rQ" = (
/obj/decal/tile_edge/line/black{
	dir = 6;
	icon_state = "line2"
	},
/turf/floor/carpet/grime,
/area/titlescreen)
"sf" = (
/obj/decal/cleanable/dirt/random,
/turf/floor/grime,
/area/titlescreen)
"to" = (
/obj/decal/slipmat/torn,
/obj/decal/cleanable/dirt/random,
/obj/machinery/light/small/reddish{
	dir = 8
	},
/turf/floor/grime,
/area/titlescreen)
"uz" = (
/turf/floor/nevicata/wastes/path,
/area/titlescreen)
"vi" = (
/obj/table/reinforced/auto,
/obj/item/storage/firstaid/regular{
	pixel_x = -8;
	pixel_y = 1
	},
/obj/item/storage/firstaid/regular{
	pixel_x = 1;
	pixel_y = 3
	},
/obj/item/reagent_containers/food/drinks/tea{
	pixel_y = 7;
	pixel_x = 14
	},
/turf/floor/black,
/area/titlescreen)
"vj" = (
/turf/floor/tangerineblack{
	dir = 8
	},
/area/titlescreen)
"vv" = (
/obj/stool/chair/office/orange{
	dir = 8
	},
/turf/floor/black,
/area/titlescreen)
"vF" = (
/turf/wall,
/area/titlescreen)
"vI" = (
/obj/machinery/light/small/frostedred{
	dir = 1;
	pixel_x = 10
	},
/obj/item/raw_material/ice/nevicata,
/turf/floor/nevicata/wastes,
/area/titlescreen)
"vM" = (
/obj/storage/crate/bin/dumpster/full,
/turf/floor/nevicata/wastes/plating,
/area/titlescreen)
"wf" = (
/turf/floor/tangerineblack{
	dir = 4
	},
/area/titlescreen)
"wi" = (
/obj/decal/tile_edge/line/black{
	dir = 8;
	icon_state = "line1"
	},
/obj/stool/chair{
	dir = 4
	},
/obj/decal/fakeobjects{
	desc = "They're just happy to be here, folks.";
	icon = 'icons/mob/critter.dmi';
	icon_state = "paisano-generic";
	layer = 4;
	name = "paisano"
	},
/turf/floor/carpet/grime,
/area/titlescreen)
"wu" = (
/obj/stool/chair{
	dir = 4
	},
/turf/floor/nevicata/wastes/plating,
/area/titlescreen)
"yk" = (
/obj/machinery/door/airlock/gannets/glass/toxins{
	name = "glass recon airlock"
	},
/turf/floor/black,
/area/titlescreen)
"yA" = (
/obj/railing/cool{
	dir = 8
	},
/obj/railing/cool,
/turf/floor/nevicata/wastes,
/area/titlescreen)
"yM" = (
/obj/table/clothchecker/auto,
/obj/item/device/light/candle/small{
	pixel_x = 6;
	pixel_y = 9;
	burning = 1
	},
/obj/item/decoration/flower_vase/vase7{
	pixel_x = -2
	},
/obj/item/device/light/candle/small{
	pixel_y = 2;
	burning = 1
	},
/turf/floor/carpet/grime,
/area/titlescreen)
"yW" = (
/obj/railing/cool{
	dir = 4
	},
/obj/railing/cool,
/turf/floor/nevicata/wastes,
/area/titlescreen)
"Bf" = (
/obj/machinery/light/small/frostedred{
	dir = 1;
	pixel_x = 10
	},
/turf/floor/nevicata/wastes,
/area/titlescreen)
"Bu" = (
/turf/floor/nevicata/wastes,
/area/titlescreen)
"BU" = (
/turf/floor/tangerineblack{
	dir = 1
	},
/area/titlescreen)
"Cq" = (
/obj/item/hand_warmer/dead{
	pixel_y = 4;
	pixel_x = -7
	},
/obj/decal/cleanable/dirt/random,
/turf/floor/nevicata/wastes/plating,
/area/titlescreen)
"Dd" = (
/obj/storage/crate/packing{
	icon_state = "packingcrate6"
	},
/obj/machinery/light/small/frostedred{
	dir = 8
	},
/turf/floor/nevicata/wastes,
/area/titlescreen)
"Dr" = (
/obj/chainlink_fence{
	dir = 5
	},
/turf/floor/nevicata/wastes/beaten,
/area/titlescreen)
"DK" = (
/obj/chainlink_fence,
/obj/machinery/light/small/frostedred{
	dir = 8
	},
/turf/floor/nevicata/wastes/plating,
/area/titlescreen)
"Fe" = (
/obj/decal/tile_edge/line/black{
	dir = 4;
	icon_state = "line1"
	},
/obj/stool/chair{
	dir = 8;
	icon_state = "chair"
	},
/obj/decal/cleanable/dirt/random,
/turf/floor/carpet/grime,
/area/titlescreen)
"Gf" = (
/obj/table/reinforced/auto,
/obj/item/gun/modular/NT/flare_gun,
/obj/item/gun/modular/NT/flare_gun{
	pixel_y = 8
	},
/turf/floor/black,
/area/titlescreen)
"Hu" = (
/obj/decal/cleanable/dirt/random,
/obj/machinery/space_heater,
/turf/floor/tangerineblack{
	dir = 1
	},
/area/titlescreen)
"HN" = (
/obj/decal/tile_edge/line/black{
	icon_state = "line1"
	},
/turf/floor/carpet/grime,
/area/titlescreen)
"HQ" = (
/obj/railing/cool,
/turf/floor/nevicata/wastes,
/area/titlescreen)
"HW" = (
/obj/machinery/light/small/purpleish,
/turf/floor/wood/five,
/area/titlescreen)
"Jv" = (
/obj/table,
/obj/item_dispenser/towel{
	pixel_y = 2
	},
/obj/item/material_piece/cloth/rag{
	pixel_y = 2;
	pixel_x = 9
	},
/turf/floor/grime,
/area/titlescreen)
"Lj" = (
/obj/decal/fakeobjects{
	anchored = 1;
	density = 1;
	desc = "A long-dead industrial washing machine.  I guess it's more of a dirtying machine now.  A rusting machine.";
	dir = 1;
	icon = 'icons/misc/hospital.dmi';
	icon_state = "washer";
	name = "washing machine"
	},
/obj/machinery/light/small/greenish{
	dir = 4
	},
/turf/floor/grime,
/area/titlescreen)
"LL" = (
/turf/floor/grime,
/area/titlescreen)
"MV" = (
/obj/decal/tile_edge/stripe/extra_big{
	dir = 4
	},
/turf/floor/industrial,
/area/titlescreen)
"NC" = (
/obj/decal/cleanable/dirt/random,
/turf/floor/tangerineblack{
	dir = 4
	},
/area/titlescreen)
"NH" = (
/obj/item/cigbutt{
	pixel_x = -1;
	pixel_y = 8
	},
/obj/item/cigbutt{
	pixel_x = -19
	},
/obj/decal/cleanable/mess/random_litter,
/turf/floor/nevicata/wastes/plating,
/area/titlescreen)
"Od" = (
/obj/chainlink_fence{
	dir = 10
	},
/obj/chainlink_fence{
	dir = 1
	},
/turf/floor/nevicata/wastes/beaten,
/area/titlescreen)
"Pp" = (
/obj/decal/cleanable/dirt/random,
/turf/floor/black,
/area/titlescreen)
"PD" = (
/turf/floor/nevicata/wastes/beaten,
/area/titlescreen)
"PT" = (
/obj/table/reinforced/auto,
/obj/item/device/radio/headset/multifreq,
/obj/item/device/radio/headset/multifreq{
	pixel_y = 6;
	pixel_x = 6
	},
/turf/floor/black,
/area/titlescreen)
"Rc" = (
/obj/table/reinforced/auto,
/obj/item/reagent_containers/food/drinks/coffee{
	pixel_x = 10;
	pixel_y = -6
	},
/obj/item/clothing/suit/cryo/recon{
	pixel_y = 9;
	pixel_x = 3
	},
/turf/floor/black,
/area/titlescreen)
"RK" = (
/obj/decal/tile_edge/stripe/extra_big{
	dir = 4
	},
/obj/machinery/light/small/reddish{
	dir = 4
	},
/turf/floor/industrial,
/area/titlescreen)
"SK" = (
/obj/machinery/light/fluorescent/ceiling/cool,
/turf/floor/black,
/area/titlescreen)
"Tn" = (
/obj/wingrille_spawn/reinforced,
/turf/floor/plating,
/area/titlescreen)
"TX" = (
/obj/neon_sign/open{
	pixel_y = 32
	},
/turf/floor/nevicata/wastes/beaten,
/area/titlescreen)
"Vf" = (
/turf/floor/black,
/area/titlescreen)
"VA" = (
/obj/decal/tile_edge/stripe/extra_big{
	dir = 8
	},
/obj/decal/cleanable/dirt/random,
/turf/floor/industrial,
/area/titlescreen)
"Wd" = (
/obj/chainlink_fence{
	dir = 1
	},
/obj/chainlink_fence{
	dir = 10
	},
/turf/floor/nevicata/wastes,
/area/titlescreen)
"WB" = (
/obj/shrub/big,
/turf/floor/planter/strips{
	dir = 8
	},
/area/titlescreen)
"XD" = (
/obj/shrub/big/big3,
/turf/floor/planter/strips{
	dir = 10
	},
/area/titlescreen)
"Yn" = (
/obj/decal/tile_edge/stripe/extra_big{
	dir = 8
	},
/turf/floor/industrial,
/area/titlescreen)
"ZR" = (
/obj/railing/cool,
/turf/floor/nevicata/wastes/path,
/area/titlescreen)

(1,1,1) = {"
vF
vF
vF
vF
Bu
HQ
PD
iy
iy
iy
iy
yk
VA
Yn
Yn
"}
(2,1,1) = {"
hv
pm
WB
Tn
Bu
HQ
PD
iy
iy
iy
iy
yk
RK
MV
MV
"}
(3,1,1) = {"
wi
iB
XD
Tn
Bu
HQ
PD
iy
iy
PD
PD
ac
ac
yk
Tn
"}
(4,1,1) = {"
yM
HN
HW
vF
Bu
HQ
PD
iy
iy
uz
ac
ac
vj
qi
qi
"}
(5,1,1) = {"
Fe
rQ
oi
Tn
Bu
HQ
PD
iy
iy
uz
aM
Hu
Vf
SK
Vf
"}
(6,1,1) = {"
hv
pm
pm
Tn
vI
yW
PD
iy
iy
uz
ac
BU
aE
Gf
PT
"}
(7,1,1) = {"
vF
vF
vF
vF
co
PD
PD
iy
iy
uz
Tn
BU
Vf
vi
rr
"}
(8,1,1) = {"
kx
to
kx
iy
iy
iy
iy
iy
iy
uz
ac
po
Vf
Rc
lJ
"}
(9,1,1) = {"
kx
cQ
kx
iy
iy
iy
iy
iy
iy
uz
Tn
cF
Pp
SK
vv
"}
(10,1,1) = {"
vF
vF
vF
vF
TX
PD
PD
iy
iy
uz
ac
lP
wf
wf
NC
"}
(11,1,1) = {"
pV
sf
LL
Tn
Bf
yA
PD
iy
iy
uz
ac
ac
ac
ac
ac
"}
(12,1,1) = {"
vF
Lj
Jv
Tn
Bu
HQ
PD
iy
iy
uz
Bu
Dd
hU
lG
lG
"}
(13,1,1) = {"
vF
vF
vF
vF
Bu
aT
PD
iy
iy
ZR
Bu
Bu
Bu
lG
lG
"}
(14,1,1) = {"
aO
wu
DK
Bu
PD
PD
PD
iy
iy
ZR
Bu
Bu
aH
lG
qz
"}
(15,1,1) = {"
Cq
NH
mH
PD
PD
PD
PD
iy
iy
ZR
Bu
Bu
lG
lG
qz
"}
(16,1,1) = {"
dH
aL
Od
PD
PD
HQ
PD
iy
iy
ZR
Bu
lG
lG
qz
qz
"}
(17,1,1) = {"
vM
fk
Dr
Bu
Bu
HQ
PD
iy
iy
ZR
Bu
lG
lG
qz
qz
"}
(18,1,1) = {"
lG
lG
Wd
Bu
Bu
HQ
PD
iy
iy
ZR
Bu
lG
lG
qz
qz
"}
(19,1,1) = {"
qz
lG
Bu
Bu
Bu
HQ
PD
iy
iy
ZR
Bu
lG
lG
qz
qz
"}
(20,1,1) = {"
qz
lG
lG
aH
Bu
HQ
PD
iy
iy
ZR
Bu
lG
lG
lG
qz
"}
(21,1,1) = {"
qz
qz
lG
lG
Bu
HQ
PD
iy
iy
ZR
Bu
Bu
lG
lG
qz
"}
