//MAP CONVERTED BY dmm2tgm.py THIS HEADER COMMENT PREVENTS RECONVERSION, DO NOT REMOVE
"bg" = (
/obj/decal/slipmat,
/turf/floor/blackwhite/whitegrime,
/area/titlescreen)
"bo" = (
/obj/random_item_spawner/junk/one,
/turf/space/gehenna/desert/corner{
	dir = 6
	},
/area/titlescreen)
"bT" = (
/obj/railway/rusty,
/obj/decoration/railbed/cracked1,
/turf/space/gehenna/desert/no_spikes,
/area/titlescreen)
"bW" = (
/obj/railway/rusty,
/obj/decoration/railbed,
/turf/space/gehenna/desert/beaten,
/area/titlescreen)
"cW" = (
/obj/decal/poster/wallsign/warning3,
/turf/wall,
/area/titlescreen)
"dd" = (
/obj/machinery/light/runway_light,
/turf/space/gehenna/desert/corner{
	dir = 8
	},
/area/titlescreen)
"dn" = (
/turf/space/gehenna/desert/plating,
/area/titlescreen)
"dq" = (
/turf/space/gehenna/desert/path{
	dir = 8
	},
/area/titlescreen)
"dB" = (
/turf/space/gehenna/desert/path{
	dir = 1
	},
/area/titlescreen)
"dN" = (
/obj/machinery/light/runway_light/delay5,
/turf/space/gehenna/desert/corner{
	dir = 6
	},
/area/titlescreen)
"dT" = (
/obj/chainlink_fence{
	dir = 10
	},
/turf/space/gehenna/desert,
/area/titlescreen)
"eL" = (
/obj/landmark{
	name = "lobby_leftside"
	},
/turf/space/gehenna/desert,
/area/titlescreen)
"eN" = (
/turf/space/gehenna/desert/path{
	dir = 9
	},
/area/titlescreen)
"eU" = (
/turf/space/gehenna/desert,
/area/titlescreen)
"fF" = (
/obj/machinery/door/airlock/external{
	name = "Grub Processing"
	},
/turf/floor/plating,
/area/titlescreen)
"hy" = (
/obj/machinery/light/runway_light/delay4,
/turf/space/gehenna/desert/path{
	dir = 1
	},
/area/titlescreen)
"hz" = (
/turf/space/gehenna/desert/corner{
	dir = 8
	},
/area/titlescreen)
"hU" = (
/obj/machinery/light/runway_light/delay3,
/turf/space/gehenna/desert/corner{
	dir = 8
	},
/area/titlescreen)
"jW" = (
/obj/chainlink_fence,
/turf/space/gehenna/desert/path,
/area/titlescreen)
"kb" = (
/obj/wingrille_spawn/reinforced,
/turf/floor/plating,
/area/titlescreen)
"kz" = (
/obj/random_item_spawner/junk/one_or_zero,
/turf/space/gehenna/desert/beaten,
/area/titlescreen)
"lZ" = (
/turf/space/gehenna/desert/path{
	dir = 4
	},
/area/titlescreen)
"nf" = (
/obj/decal/landing_gear_prints_gehenna{
	dir = 4;
	pixel_x = 21;
	pixel_y = 7
	},
/turf/space/gehenna/desert/path{
	dir = 10
	},
/area/titlescreen)
"nl" = (
/turf/space/gehenna/desert/corner{
	dir = 1
	},
/area/titlescreen)
"nv" = (
/obj/table/reinforced/auto,
/turf/floor/blackwhite/whitegrime,
/area/titlescreen)
"os" = (
/obj/railway/rusty,
/turf/space/gehenna/desert/beaten,
/area/titlescreen)
"oC" = (
/obj/decal/beaten_edge_thin{
	dir = 8
	},
/turf/space/gehenna/desert,
/area/titlescreen)
"pd" = (
/obj/decal/landing_gear_prints_gehenna{
	dir = 4;
	pixel_x = 21;
	pixel_y = -8
	},
/turf/space/gehenna/desert/beaten,
/area/titlescreen)
"pj" = (
/obj/iv_stand,
/turf/space/gehenna/desert/path{
	dir = 1
	},
/area/titlescreen)
"pV" = (
/obj/railway/rusty,
/obj/decoration/railbed,
/turf/space/gehenna/desert/corner{
	dir = 6
	},
/area/titlescreen)
"qe" = (
/obj/decal/beaten_edge_thin{
	dir = 1;
	pixel_x = -10
	},
/turf/space/gehenna/desert,
/area/titlescreen)
"qB" = (
/obj/machinery/light/runway_light,
/turf/space/gehenna/desert/corner{
	dir = 4
	},
/area/titlescreen)
"rY" = (
/obj/railway/rusty,
/turf/space/gehenna/desert/path{
	dir = 8
	},
/area/titlescreen)
"sZ" = (
/obj/chainlink_fence,
/turf/space/gehenna/desert/no_spikes,
/area/titlescreen)
"tA" = (
/obj/table/reinforced/auto,
/obj/item/gun/modular/rodeo/maresleg/basic{
	pixel_y = 3
	},
/turf/floor/blackwhite/whitegrime/other,
/area/titlescreen)
"tH" = (
/obj/random_item_spawner/junk/one_or_zero,
/turf/space/gehenna/desert/corner{
	dir = 1
	},
/area/titlescreen)
"tZ" = (
/turf/space/gehenna/desert/path{
	dir = 10
	},
/area/titlescreen)
"vj" = (
/obj/railway/rusty,
/turf/space/gehenna/desert/path{
	dir = 4
	},
/area/titlescreen)
"vz" = (
/obj/chainlink_fence,
/turf/space/gehenna/desert/corner{
	dir = 6
	},
/area/titlescreen)
"vX" = (
/obj/random_item_spawner/junk/one_or_zero,
/turf/space/gehenna/desert,
/area/titlescreen)
"wn" = (
/obj/chainlink_fence,
/turf/space/gehenna/desert,
/area/titlescreen)
"wJ" = (
/obj/railway/rusty,
/obj/decoration/railbed,
/obj/traincar/NT_shipping,
/turf/space/gehenna/desert/no_spikes,
/area/titlescreen)
"wT" = (
/obj/table/reinforced/auto,
/obj/item/kitchen/utensil/knife/cleaver{
	pixel_x = -7;
	pixel_y = 3
	},
/obj/machinery/light/fluorescent/ceiling/red,
/turf/floor/blackwhite/whitegrime,
/area/titlescreen)
"xv" = (
/obj/decal/beaten_edge_thin{
	pixel_x = -10
	},
/obj/decal/gehennagrass,
/turf/space/gehenna/desert,
/area/titlescreen)
"xD" = (
/obj/item/storage/toilet,
/turf/space/gehenna/desert,
/area/titlescreen)
"yK" = (
/obj/random_item_spawner/junk/one,
/turf/space/gehenna/desert/plating,
/area/titlescreen)
"yR" = (
/obj/machinery/light/runway_light/delay4,
/turf/space/gehenna/desert/path,
/area/titlescreen)
"yV" = (
/obj/chainlink_fence{
	dir = 6
	},
/turf/space/gehenna/desert/corner{
	dir = 8
	},
/area/titlescreen)
"zv" = (
/obj/landmark{
	name = "new_player"
	},
/turf/space/gehenna/desert/path{
	dir = 1
	},
/area/titlescreen)
"Bc" = (
/obj/decal/landing_gear_prints_gehenna{
	dir = 4
	},
/turf/space/gehenna/desert/beaten,
/area/titlescreen)
"Br" = (
/mob/living/critter/grub/wildgrub{
	ai_type = "/datum/aiHolder/wanderer";
	dir = 8
	},
/turf/space/gehenna/desert/beaten,
/area/titlescreen)
"BO" = (
/obj/chainlink_fence{
	dir = 10
	},
/turf/space/gehenna/desert/no_spikes,
/area/titlescreen)
"Ci" = (
/obj/decal/cleanable/molten_item,
/turf/floor/blackwhite/whitegrime,
/area/titlescreen)
"CX" = (
/obj/decal/beaten_edge_thin{
	pixel_x = -9
	},
/turf/space/gehenna/desert/corner{
	dir = 9
	},
/area/titlescreen)
"Eb" = (
/obj/random_item_spawner/junk/one,
/turf/space/gehenna/desert,
/area/titlescreen)
"Ej" = (
/obj/storage/crate/bin/dumpster,
/turf/space/gehenna/desert/plating,
/area/titlescreen)
"Ew" = (
/obj/table/reinforced/auto,
/obj/item/kitchen/utensil/fork{
	dir = 2
	},
/turf/floor/blackwhite/whitegrime,
/area/titlescreen)
"Ez" = (
/obj/burning_barrel,
/turf/space/gehenna/desert,
/area/titlescreen)
"EI" = (
/obj/vehicle/forklift{
	dir = 4
	},
/turf/space/gehenna/desert,
/area/titlescreen)
"Fn" = (
/obj/decal/cleanable/rust,
/turf/floor/blackwhite/whitegrime,
/area/titlescreen)
"FD" = (
/obj/chainlink_fence,
/obj/decal/fakeobjects/csbanner,
/turf/space/gehenna/desert/path,
/area/titlescreen)
"Gs" = (
/mob/living/critter/grub/wildgrub{
	ai_type = "/datum/aiHolder/wanderer";
	dir = 1
	},
/turf/space/gehenna/desert,
/area/titlescreen)
"Gx" = (
/obj/decal/cleanable/rust/jen/grime,
/turf/floor/blackwhite/whitegrime,
/area/titlescreen)
"GT" = (
/turf/space/gehenna/desert/corner,
/area/titlescreen)
"HQ" = (
/obj/decal/cragrock,
/turf/space/gehenna/desert,
/area/titlescreen)
"Ir" = (
/obj/decoration/train_signal,
/turf/space/gehenna/desert,
/area/titlescreen)
"Ix" = (
/obj/chainlink_fence{
	dir = 6
	},
/turf/space/gehenna/desert/path{
	dir = 4
	},
/area/titlescreen)
"IA" = (
/turf/space/gehenna/desert/path{
	dir = 6
	},
/area/titlescreen)
"Jd" = (
/obj/landmark{
	name = "lobby_timer"
	},
/turf/space/gehenna/desert,
/area/titlescreen)
"Jy" = (
/obj/decal/cleanable/tracked_reagents/blood/gibs{
	icon_state = "gib1";
	pixel_y = -5
	},
/turf/floor/blackwhite/whitegrime,
/area/titlescreen)
"JU" = (
/turf/space/gehenna/desert/corner{
	dir = 9
	},
/area/titlescreen)
"Ke" = (
/obj/machinery/light/runway_light/delay3,
/turf/space/gehenna/desert/path{
	dir = 1
	},
/area/titlescreen)
"Kn" = (
/mob/living/critter/grub/wildgrub{
	ai_type = "/datum/aiHolder/wanderer"
	},
/turf/space/gehenna/desert,
/area/titlescreen)
"KX" = (
/obj/machinery/light/runway_light/delay5,
/turf/space/gehenna/desert/corner{
	dir = 5
	},
/area/titlescreen)
"Li" = (
/obj/railway/rusty,
/obj/decoration/railbed/cracked2,
/obj/traincar/NT_engine,
/turf/space/gehenna/desert/no_spikes,
/area/titlescreen)
"Lr" = (
/obj/decal/gehennagrass,
/turf/space/gehenna/desert,
/area/titlescreen)
"LV" = (
/turf/space/gehenna/desert/corner{
	dir = 4
	},
/area/titlescreen)
"Mg" = (
/obj/decal/poster/wallsign/poster_grub,
/turf/wall,
/area/titlescreen)
"MK" = (
/obj/table/reinforced/auto,
/obj/item/reagent_containers/food/snacks/ingredient/meat/grubmeat,
/obj/machinery/light/fluorescent/ceiling/red,
/turf/floor/blackwhite/whitegrime,
/area/titlescreen)
"ML" = (
/turf/space/gehenna/desert/beaten,
/area/titlescreen)
"MR" = (
/obj/decal/poster/wallsign/dont_drugs/do_drugs,
/turf/wall,
/area/titlescreen)
"MX" = (
/turf/wall,
/area/titlescreen)
"Nn" = (
/obj/machinery/shitty_grill,
/turf/space/gehenna/desert/plating,
/area/titlescreen)
"NI" = (
/obj/landmark{
	name = "lobby_status"
	},
/turf/space/gehenna/desert,
/area/titlescreen)
"OW" = (
/obj/railway/rusty,
/turf/space/gehenna/desert/no_spikes,
/area/titlescreen)
"Pd" = (
/obj/decoration/train_signal{
	pixel_x = -4;
	pixel_y = 2
	},
/turf/space/gehenna/desert/corner{
	dir = 9
	},
/area/titlescreen)
"Ps" = (
/obj/machinery/light/runway_light/delay2,
/turf/space/gehenna/desert/corner,
/area/titlescreen)
"Pt" = (
/obj/machinery/light/runway_light/delay2,
/turf/space/gehenna/desert/path{
	dir = 1
	},
/area/titlescreen)
"PI" = (
/obj/machinery/gibber/output_south,
/turf/floor/blackwhite/whitegrime,
/area/titlescreen)
"Qq" = (
/obj/wingrille_spawn/reinforced,
/obj/decal/gehenna/warning,
/turf/floor/plating,
/area/titlescreen)
"QK" = (
/obj/storage/cart/trash,
/turf/floor/blackwhite/whitegrime,
/area/titlescreen)
"QN" = (
/obj/railway/rusty,
/obj/decoration/railbed,
/turf/space/gehenna/desert/corner{
	dir = 8
	},
/area/titlescreen)
"QZ" = (
/turf/space/gehenna/desert/corner{
	dir = 5
	},
/area/titlescreen)
"RZ" = (
/obj/decal/beaten_edge_thin{
	dir = 1;
	pixel_x = -9
	},
/obj/random_item_spawner/junk/one,
/turf/space/gehenna/desert,
/area/titlescreen)
"Tf" = (
/obj/railway/rusty,
/obj/decoration/railbed,
/turf/space/gehenna/desert/no_spikes,
/area/titlescreen)
"TS" = (
/turf/floor/blackwhite/whitegrime,
/area/titlescreen)
"Ue" = (
/obj/railway/rusty,
/obj/decoration/railbed/cracked2,
/turf/space/gehenna/desert/no_spikes,
/area/titlescreen)
"Uz" = (
/mob/living/critter/grub/wildgrub{
	ai_type = "/datum/aiHolder/wanderer";
	dir = 4
	},
/turf/space/gehenna/desert,
/area/titlescreen)
"VA" = (
/mob/living/critter/grub/wildgrub{
	ai_type = "/datum/aiHolder/wanderer";
	dir = 8
	},
/turf/space/gehenna/desert,
/area/titlescreen)
"Wp" = (
/obj/reagent_dispensers/cleanable/ants,
/turf/floor/blackwhite/whitegrime,
/area/titlescreen)
"WG" = (
/obj/railway/rusty,
/obj/decoration/railbed/cracked1,
/turf/space/gehenna/desert/path{
	dir = 8
	},
/area/titlescreen)
"Xc" = (
/obj/decal/cleanable/rust/jen,
/obj/decal/slipmat/torn,
/turf/floor/blackwhite/whitegrime,
/area/titlescreen)
"XX" = (
/obj/chainlink_fence{
	dir = 6
	},
/turf/space/gehenna/desert/no_spikes,
/area/titlescreen)
"ZB" = (
/obj/decal/beaten_edge_thin{
	pixel_x = -9
	},
/turf/space/gehenna/desert,
/area/titlescreen)
"ZP" = (
/turf/space/gehenna/desert/corner{
	dir = 6
	},
/area/titlescreen)

(1,1,1) = {"
TS
Jy
PI
Wp
MX
Nn
vX
eU
wn
OW
Tf
wn
Lr
eU
eL
"}
(2,1,1) = {"
bg
MK
nv
Fn
kb
dn
HQ
vX
wn
OW
Tf
dT
eU
Eb
eU
"}
(3,1,1) = {"
TS
tA
QK
Gx
cW
dn
eU
EI
dT
OW
Tf
Ir
JU
dq
dq
"}
(4,1,1) = {"
Xc
Ew
Wp
TS
fF
dn
tZ
eU
Pd
rY
WG
dq
tH
ML
ML
"}
(5,1,1) = {"
TS
wT
TS
MX
Mg
dn
GT
dq
nl
os
bW
ML
ML
ML
ML
"}
(6,1,1) = {"
Gx
TS
Ci
Qq
Ej
dn
ML
kz
ML
os
QN
Ix
lZ
ZP
vX
"}
(7,1,1) = {"
MX
kb
kb
MR
dn
lZ
lZ
LV
yV
vj
pV
sZ
eU
Gs
eU
"}
(8,1,1) = {"
yK
dn
dn
dn
IA
Uz
eU
pj
jW
OW
Tf
sZ
eU
Eb
eU
"}
(9,1,1) = {"
eU
oC
eU
Eb
oC
VA
Lr
dB
jW
OW
Tf
sZ
eU
Lr
eU
"}
(10,1,1) = {"
eN
pd
tZ
eN
ML
nf
eU
dB
jW
OW
Li
sZ
xD
Eb
eU
"}
(11,1,1) = {"
nl
ML
ML
ML
ML
GT
eU
zv
jW
OW
Tf
sZ
eU
HQ
eU
"}
(12,1,1) = {"
qB
ML
ML
ML
ML
dd
CX
nl
FD
OW
Tf
sZ
eU
eU
eU
"}
(13,1,1) = {"
Pt
ML
ML
ML
ML
Ps
tH
hz
vz
OW
Ue
sZ
eU
eU
vX
"}
(14,1,1) = {"
Ke
ML
ML
ML
ML
hU
lZ
ZP
BO
OW
bT
sZ
Eb
eU
eU
"}
(15,1,1) = {"
hy
ML
ML
ML
ML
yR
eU
Eb
eU
OW
Tf
sZ
eU
vX
Lr
"}
(16,1,1) = {"
KX
ML
ML
ML
ML
dN
eU
HQ
XX
OW
Tf
BO
eU
vX
eU
"}
(17,1,1) = {"
qe
ML
Br
Bc
ML
ZB
Kn
eU
sZ
OW
Tf
eU
eU
eU
HQ
"}
(18,1,1) = {"
RZ
LV
ML
ML
hz
xv
eU
eU
sZ
OW
wJ
eU
eU
Jd
NI
"}
(19,1,1) = {"
eU
QZ
lZ
lZ
bo
eU
eU
Ez
sZ
OW
Ue
Eb
eU
eU
eU
"}
(20,1,1) = {"
Lr
vX
eU
eU
eU
eU
HQ
eU
sZ
OW
Tf
XX
Lr
eU
Eb
"}
(21,1,1) = {"
eU
eU
eU
eU
Lr
eU
eU
vX
sZ
OW
Tf
sZ
eU
eU
vX
"}
