//MAP CONVERTED BY dmm2tgm.py THIS HEADER COMMENT PREVENTS RECONVERSION, DO NOT REMOVE
"ao" = (
/obj/railing/cool{
	dir = 8
	},
/obj/railing/cool,
/turf/floor/nevicata/wastes,
/area/titlescreen)
"bm" = (
/obj/decal/cleanable/mess/sodacan,
/turf/floor/wood/five,
/area/titlescreen)
"bI" = (
/obj/chainlink_fence,
/obj/machinery/light/small/frostedred{
	dir = 8
	},
/turf/floor/nevicata/wastes/plating,
/area/titlescreen)
"bP" = (
/turf/floor/nevicata/wastes,
/area/titlescreen)
"dj" = (
/obj/chainlink_fence{
	dir = 10
	},
/obj/chainlink_fence{
	dir = 1
	},
/turf/floor/nevicata/wastes/beaten,
/area/titlescreen)
"dr" = (
/obj/decal/tile_edge/line/black{
	dir = 10;
	icon_state = "line2"
	},
/turf/floor/carpet/grime,
/area/titlescreen)
"dy" = (
/obj/landmark{
	name = "lobby_status"
	},
/turf/wall/asteroid/nevicata/tough,
/area/titlescreen)
"dM" = (
/obj/table/reinforced/auto,
/obj/item/storage/firstaid/regular{
	pixel_x = -8;
	pixel_y = 1
	},
/obj/item/storage/firstaid/regular{
	pixel_x = 1;
	pixel_y = 3
	},
/obj/item/reagent_containers/food/drinks/tea{
	pixel_y = 7;
	pixel_x = 14
	},
/turf/floor/black,
/area/titlescreen)
"er" = (
/obj/machinery/door/airlock/gannets/glass,
/turf/floor/grime,
/area/titlescreen)
"fd" = (
/obj/burning_barrel,
/turf/floor/nevicata/wastes/plating,
/area/titlescreen)
"fw" = (
/obj/wingrille_spawn/reinforced,
/obj/decal/cleanable/dirt/random,
/turf/floor/plating,
/area/titlescreen)
"fV" = (
/obj/machinery/light/small/frostedred{
	dir = 1;
	pixel_x = 10
	},
/turf/floor/nevicata/wastes,
/area/titlescreen)
"gs" = (
/obj/stool/chair/office/orange{
	dir = 8
	},
/turf/floor/black,
/area/titlescreen)
"gz" = (
/obj/decal/tile_edge/line/black{
	dir = 6;
	icon_state = "line2"
	},
/turf/floor/carpet/grime,
/area/titlescreen)
"gL" = (
/obj/item/cigbutt{
	pixel_x = -1;
	pixel_y = 8
	},
/obj/item/cigbutt{
	pixel_x = -19
	},
/obj/decal/cleanable/mess/random_litter,
/turf/floor/nevicata/wastes/plating,
/area/titlescreen)
"gO" = (
/obj/decal/fakeobjects{
	anchored = 1;
	density = 1;
	desc = "A long-dead industrial washing machine.  I guess it's more of a dirtying machine now.  A rusting machine.";
	dir = 1;
	icon = 'icons/misc/hospital.dmi';
	icon_state = "washer";
	name = "washing machine"
	},
/obj/machinery/light/small/greenish{
	dir = 4
	},
/turf/floor/grime,
/area/titlescreen)
"gQ" = (
/obj/decal/tile_edge/line/black{
	icon_state = "line1"
	},
/obj/machinery/light/fluorescent/ceiling/cool,
/turf/floor/carpet/grime,
/area/titlescreen)
"hw" = (
/turf/floor/nevicata/wastes/beaten,
/area/titlescreen)
"hA" = (
/obj/railing/cool,
/turf/floor/nevicata/wastes/beaten,
/area/titlescreen)
"hV" = (
/obj/decal/cleanable/tracked_reagents/blood/splatter/extra,
/turf/floor/nevicata/wastes/plating,
/area/titlescreen)
"ji" = (
/obj/railing/cool,
/obj/decal/cleanable/tracked_reagents/blood/splatter/extra,
/turf/floor/nevicata/wastes/path,
/area/titlescreen)
"jr" = (
/turf/floor/nevicata/wastes/plating,
/area/titlescreen)
"kO" = (
/obj/machinery/light/small/frostedred{
	dir = 1;
	pixel_x = 10
	},
/obj/item/raw_material/ice/nevicata,
/turf/floor/nevicata/wastes,
/area/titlescreen)
"lJ" = (
/obj/stool/chair/orange{
	dir = 8
	},
/turf/floor/tangerineblack{
	dir = 5
	},
/area/titlescreen)
"mB" = (
/obj/chainlink_fence{
	dir = 1
	},
/obj/chainlink_fence{
	dir = 10
	},
/turf/floor/nevicata/wastes,
/area/titlescreen)
"nH" = (
/obj/decal/skeleton,
/turf/floor/nevicata/wastes/beaten,
/area/titlescreen)
"pc" = (
/turf/floor/tangerineblack{
	dir = 4
	},
/area/titlescreen)
"pk" = (
/turf/wall/auto/reinforced,
/area/titlescreen)
"ps" = (
/obj/machinery/door/airlock/gannets/glass,
/turf/floor/carpet/grime3,
/area/titlescreen)
"qj" = (
/obj/decal/tile_edge/stripe/extra_big{
	dir = 8
	},
/obj/landmark{
	name = "lobby_leftside"
	},
/turf/floor/industrial,
/area/titlescreen)
"qP" = (
/turf/floor/wood/five,
/area/titlescreen)
"rD" = (
/obj/stool/chair/orange{
	dir = 4
	},
/obj/decal/cleanable/dirt/random,
/turf/floor/tangerineblack{
	dir = 1
	},
/area/titlescreen)
"sm" = (
/obj/storage/crate/packing{
	icon_state = "woodencrate9"
	},
/turf/floor/nevicata/wastes,
/area/titlescreen)
"sy" = (
/obj/decal/tile_edge/line/black{
	dir = 8;
	icon_state = "line1"
	},
/obj/stool/chair{
	dir = 4
	},
/obj/decal/fakeobjects{
	desc = "They're just happy to be here, folks.";
	icon = 'icons/mob/critter.dmi';
	icon_state = "paisano-generic";
	layer = 4;
	name = "paisano"
	},
/turf/floor/carpet/grime,
/area/titlescreen)
"tm" = (
/obj/decal/cleanable/dirt/random,
/turf/floor/grime,
/area/titlescreen)
"tB" = (
/obj/dialogueobj/securitycorpse3,
/turf/floor/nevicata/wastes/plating,
/area/titlescreen)
"tC" = (
/obj/stool/chair{
	dir = 4
	},
/turf/floor/nevicata/wastes/plating,
/area/titlescreen)
"tF" = (
/obj/decal/tile_edge/stripe/extra_big{
	dir = 4
	},
/obj/machinery/light/small/reddish{
	dir = 4
	},
/turf/floor/industrial,
/area/titlescreen)
"tG" = (
/obj/dialogueobj/securitycorpse7,
/turf/floor/nevicata/wastes/plating,
/area/titlescreen)
"ug" = (
/obj/decal/slipmat/torn,
/obj/decal/cleanable/dirt/random,
/obj/machinery/light/small/reddish{
	dir = 8
	},
/turf/floor/grime,
/area/titlescreen)
"uA" = (
/obj/railing/cool,
/turf/floor/nevicata/wastes/path,
/area/titlescreen)
"vj" = (
/obj/table/clothchecker/auto,
/obj/item/device/light/candle/small{
	pixel_x = 6;
	pixel_y = 9;
	burning = 1
	},
/obj/item/decoration/flower_vase/vase7{
	pixel_x = -2
	},
/obj/item/device/light/candle/small{
	pixel_y = 2;
	burning = 1
	},
/turf/floor/carpet/grime,
/area/titlescreen)
"vn" = (
/obj/railing/cool{
	dir = 4
	},
/obj/railing/cool,
/turf/floor/nevicata/wastes,
/area/titlescreen)
"vO" = (
/obj/decal/tile_edge/stripe/extra_big{
	dir = 8
	},
/turf/floor/industrial,
/area/titlescreen)
"wY" = (
/obj/decal/tile_edge/stripe/extra_big{
	dir = 4
	},
/turf/floor/industrial,
/area/titlescreen)
"xA" = (
/obj/stool/chair/office/orange,
/turf/floor/black,
/area/titlescreen)
"xE" = (
/obj/decal/cleanable/dirt/random,
/obj/item/raw_material/ice/nevicata,
/turf/floor/nevicata/wastes/plating,
/area/titlescreen)
"xH" = (
/obj/decal/cleanable/tracked_reagents/blood/tracks{
	dir = 4
	},
/turf/floor/nevicata/wastes/path,
/area/titlescreen)
"xJ" = (
/obj/machinery/door/airlock/gannets/glass/toxins{
	name = "glass recon airlock"
	},
/turf/floor/black,
/area/titlescreen)
"zs" = (
/obj/table/auto,
/obj/item/card_box/plain{
	pixel_y = 3;
	pixel_x = 2
	},
/obj/item/cigpacket/menthol{
	pixel_x = -8;
	pixel_y = 3
	},
/turf/floor/tangerineblack{
	dir = 1
	},
/area/titlescreen)
"zW" = (
/obj/item/hand_warmer/dead{
	pixel_y = 4;
	pixel_x = -7
	},
/obj/decal/cleanable/dirt/random,
/turf/floor/nevicata/wastes/plating,
/area/titlescreen)
"zY" = (
/turf/floor/nevicata/wastes/path,
/area/titlescreen)
"AB" = (
/obj/item/casing/small,
/turf/floor/nevicata/wastes/plating,
/area/titlescreen)
"AP" = (
/obj/table/reinforced/auto,
/obj/item/plate{
	pixel_y = 8;
	pixel_x = 1
	},
/obj/item/reagent_containers/food/snacks/condiment/syrup{
	pixel_y = 21;
	pixel_x = -6
	},
/obj/item/reagent_containers/food/snacks/pancake{
	pixel_y = 7;
	pixel_x = 1
	},
/obj/item/kitchen/utensil/fork{
	pixel_y = -4;
	pixel_x = 3;
	dir = 8
	},
/turf/floor/black,
/area/titlescreen)
"BC" = (
/turf/wall/asteroid/nevicata/tough,
/area/titlescreen)
"Cp" = (
/obj/storage/crate/bin/dumpster/full,
/turf/floor/nevicata/wastes/plating,
/area/titlescreen)
"Cw" = (
/obj/decal/cleanable/tracked_reagents/blood/splatter,
/turf/floor/nevicata/wastes/plating,
/area/titlescreen)
"Dd" = (
/turf/floor/tangerineblack{
	dir = 1
	},
/area/titlescreen)
"Df" = (
/obj/table/folding,
/obj/item/reagent_containers/food/drinks/coffee{
	pixel_y = 9;
	pixel_x = -4
	},
/obj/item/decoration/ashtray{
	pixel_y = 4;
	pixel_x = 4
	},
/turf/floor/nevicata/wastes/plating,
/area/titlescreen)
"Di" = (
/obj/table/reinforced/auto,
/obj/item/gun/modular/NT/flare_gun,
/obj/item/gun/modular/NT/flare_gun{
	pixel_y = 8
	},
/turf/floor/black,
/area/titlescreen)
"Dm" = (
/obj/shrub/big/big3,
/turf/floor/planter/strips{
	dir = 10
	},
/area/titlescreen)
"Dp" = (
/obj/decal/cleanable/tracked_reagents/blood/gibs/body,
/turf/floor/nevicata/wastes/plating,
/area/titlescreen)
"Dr" = (
/obj/item/body_bag/deployed,
/turf/floor/nevicata/wastes,
/area/titlescreen)
"Fo" = (
/obj/decal/skeleton/decomposed_corpse,
/turf/floor/nevicata/wastes/plating,
/area/titlescreen)
"Fw" = (
/obj/decal/tile_edge/line/black{
	dir = 4;
	icon_state = "line1"
	},
/obj/stool/chair{
	dir = 8;
	icon_state = "chair"
	},
/obj/decal/cleanable/dirt/random,
/turf/floor/carpet/grime,
/area/titlescreen)
"Gr" = (
/obj/railing/cool,
/obj/decal/cleanable/tracked_reagents/blood/gibs,
/turf/floor/nevicata/wastes/path,
/area/titlescreen)
"GF" = (
/obj/decal/cleanable/mess/sodacan,
/turf/floor/nevicata/wastes/beaten,
/area/titlescreen)
"HZ" = (
/obj/decal/cleanable/tracked_reagents/blood/drip/high,
/turf/floor/nevicata/wastes/path,
/area/titlescreen)
"Il" = (
/turf/wall,
/area/titlescreen)
"IZ" = (
/obj/decal/slipmat,
/turf/floor/grime,
/area/titlescreen)
"Je" = (
/obj/railing/cool,
/turf/floor/nevicata/wastes,
/area/titlescreen)
"Kg" = (
/obj/shrub/big/big3,
/turf/floor/planter,
/area/titlescreen)
"Ks" = (
/obj/neon_sign/caviar{
	pixel_y = 37
	},
/turf/floor/nevicata/wastes/beaten,
/area/titlescreen)
"KD" = (
/obj/dialogueobj/engineerscorpse,
/obj/decal/cleanable/tracked_reagents/blood/tracks{
	dir = 4
	},
/turf/floor/nevicata/wastes/path,
/area/titlescreen)
"KX" = (
/obj/head_on_spike,
/turf/floor/nevicata/wastes/plating,
/area/titlescreen)
"Lh" = (
/obj/item/gun/modular/NT/pistol_sec,
/obj/item/casing,
/obj/item/casing/small,
/turf/floor/nevicata/wastes/plating,
/area/titlescreen)
"Lq" = (
/obj/wingrille_spawn/reinforced,
/turf/floor/plating,
/area/titlescreen)
"LC" = (
/obj/decal/cleanable/dirt/random,
/turf/floor/black,
/area/titlescreen)
"LW" = (
/obj/table/reinforced/auto,
/obj/item/device/radio/headset/multifreq,
/obj/item/device/radio/headset/multifreq{
	pixel_y = 6;
	pixel_x = 6
	},
/turf/floor/black,
/area/titlescreen)
"Ma" = (
/turf/floor/grime,
/area/titlescreen)
"Mp" = (
/turf/wall/asteroid/nevicata,
/area/titlescreen)
"MO" = (
/obj/decal/cleanable/dirt/random,
/turf/floor/wood/five,
/area/titlescreen)
"MV" = (
/obj/item/raw_material/ice/nevicata,
/turf/floor/nevicata/wastes,
/area/titlescreen)
"NH" = (
/obj/machinery/light/fluorescent/ceiling/cool,
/turf/floor/black,
/area/titlescreen)
"NP" = (
/obj/neon_sign/open{
	pixel_y = 32
	},
/turf/floor/nevicata/wastes/beaten,
/area/titlescreen)
"On" = (
/obj/decal/cleanable/dirt/random,
/turf/floor/tangerineblack{
	dir = 4
	},
/area/titlescreen)
"Rk" = (
/obj/storage/crate/packing{
	icon_state = "packingcrate6"
	},
/obj/machinery/light/small/frostedred{
	dir = 8
	},
/turf/floor/nevicata/wastes,
/area/titlescreen)
"RD" = (
/obj/decal/cleanable/dirt/random,
/turf/floor/tangerineblack{
	dir = 8
	},
/area/titlescreen)
"Ti" = (
/obj/landmark{
	name = "new_player"
	},
/turf/floor/nevicata/wastes/plating,
/area/titlescreen)
"Tn" = (
/obj/shrub/big,
/turf/floor/planter/strips{
	dir = 8
	},
/area/titlescreen)
"Tr" = (
/obj/table,
/obj/item_dispenser/towel{
	pixel_y = 2
	},
/obj/item/material_piece/cloth/rag{
	pixel_y = 2;
	pixel_x = 9
	},
/turf/floor/grime,
/area/titlescreen)
"Tx" = (
/turf/floor/tangerineblack{
	dir = 8
	},
/area/titlescreen)
"Vu" = (
/obj/chainlink_fence,
/turf/floor/nevicata/wastes/beaten,
/area/titlescreen)
"Vz" = (
/obj/item/gun/modular/NT/pistol_sec,
/turf/floor/nevicata/wastes/plating,
/area/titlescreen)
"VF" = (
/obj/chainlink_fence{
	dir = 5
	},
/turf/floor/nevicata/wastes/beaten,
/area/titlescreen)
"Wj" = (
/obj/item/casing/small,
/obj/item/casing/small{
	pixel_y = -5;
	pixel_x = -5
	},
/turf/floor/nevicata/wastes/plating,
/area/titlescreen)
"Wr" = (
/turf/floor/black,
/area/titlescreen)
"Ww" = (
/obj/railing/cool,
/obj/decal/cleanable/tracked_reagents/blood/drip/med,
/turf/floor/nevicata/wastes,
/area/titlescreen)
"WE" = (
/obj/decal/cleanable/tracked_reagents/blood/tracks{
	dir = 4
	},
/turf/floor/nevicata/wastes/beaten,
/area/titlescreen)
"WN" = (
/obj/landmark{
	name = "lobby_timer"
	},
/turf/wall/asteroid/nevicata/tough,
/area/titlescreen)
"XJ" = (
/obj/table/reinforced/auto,
/obj/item/reagent_containers/food/drinks/coffee{
	pixel_x = 10;
	pixel_y = -6
	},
/obj/item/clothing/suit/cryo/recon{
	pixel_y = 9;
	pixel_x = 3
	},
/turf/floor/black,
/area/titlescreen)
"YW" = (
/obj/machinery/shitty_grill,
/turf/floor/nevicata/wastes,
/area/titlescreen)
"ZH" = (
/obj/decal/tile_edge/stripe/extra_big{
	dir = 8
	},
/obj/decal/cleanable/dirt/random,
/turf/floor/industrial,
/area/titlescreen)
"ZM" = (
/obj/decal/cleanable/dirt/random,
/obj/machinery/space_heater,
/turf/floor/tangerineblack{
	dir = 1
	},
/area/titlescreen)

(1,1,1) = {"
Il
Il
Il
Il
bP
Je
hw
jr
jr
jr
jr
xJ
ZH
vO
qj
"}
(2,1,1) = {"
qP
MO
Tn
Lq
bP
Je
hw
jr
jr
jr
jr
xJ
tF
wY
wY
"}
(3,1,1) = {"
sy
dr
Dm
Lq
bP
Je
hw
jr
jr
hw
hw
pk
pk
xJ
Lq
"}
(4,1,1) = {"
vj
gQ
qP
Il
bP
Je
hw
jr
jr
zY
pk
pk
Tx
RD
RD
"}
(5,1,1) = {"
Fw
gz
bm
Lq
bP
Je
hw
jr
jr
zY
fw
ZM
Wr
NH
Wr
"}
(6,1,1) = {"
qP
MO
MO
Lq
kO
vn
hw
jr
jr
KD
pk
Dd
xA
Di
LW
"}
(7,1,1) = {"
Il
Il
Il
Il
Ks
hw
hw
jr
jr
xH
Lq
Dd
Wr
dM
Kg
"}
(8,1,1) = {"
er
ug
er
jr
jr
jr
jr
Cw
Lh
zY
pk
rD
Wr
XJ
AP
"}
(9,1,1) = {"
er
IZ
er
jr
jr
jr
tG
jr
Wj
HZ
Lq
zs
LC
NH
gs
"}
(10,1,1) = {"
Il
Il
Il
Il
NP
hw
WE
jr
jr
zY
pk
lJ
pc
pc
On
"}
(11,1,1) = {"
ps
tm
Ma
Lq
fV
ao
WE
Ti
Fo
zY
pk
pk
pk
pk
pk
"}
(12,1,1) = {"
Il
gO
Tr
Lq
bP
Je
WE
jr
jr
zY
bP
Rk
sm
Mp
Mp
"}
(13,1,1) = {"
Il
Il
Il
Il
bP
hA
hw
KX
jr
uA
bP
bP
bP
Mp
Mp
"}
(14,1,1) = {"
Df
tC
bI
bP
hw
hw
hw
hV
jr
uA
bP
Dr
MV
Mp
BC
"}
(15,1,1) = {"
zW
gL
Vu
hw
hw
hw
hw
jr
jr
Gr
bP
bP
Mp
Mp
BC
"}
(16,1,1) = {"
fd
GF
dj
hw
hw
Je
nH
Vz
jr
uA
Dr
Mp
Mp
BC
BC
"}
(17,1,1) = {"
Cp
xE
VF
bP
bP
Ww
hw
jr
tB
ji
bP
Mp
Mp
BC
BC
"}
(18,1,1) = {"
Mp
Mp
mB
bP
bP
Je
hw
Dp
AB
uA
bP
Mp
Mp
WN
dy
"}
(19,1,1) = {"
BC
Mp
YW
bP
bP
Je
hw
jr
jr
uA
bP
Mp
Mp
BC
BC
"}
(20,1,1) = {"
BC
Mp
Mp
MV
bP
Je
hw
Cw
jr
uA
bP
Mp
Mp
Mp
BC
"}
(21,1,1) = {"
BC
BC
Mp
Mp
bP
Je
hw
jr
jr
uA
bP
bP
Mp
Mp
BC
"}
