//MAP CONVERTED BY dmm2tgm.py THIS HEADER COMMENT PREVENTS RECONVERSION, DO NOT REMOVE
"a" = (
/turf/space/shuttle_transit,
/area/area_that_kills_you_if_you_enter_it)
"d" = (
/turf/space/shuttle_transit/deadly,
/area/shuttle_transit_space/north)
"e" = (
/turf/space/shuttle_transit,
/area/shuttle_transit_space/north)
"I" = (
/obj/landmark/load_prefab_shuttledmm/arrivals,
/turf/space/shuttle_transit,
/area/shuttle_transit_space/north)
"R" = (
/obj/decal/fakeobjects/thrust/flames{
	dir = 1
	},
/turf/space/shuttle_transit,
/area/shuttle_transit_space/north)

(1,1,1) = {"
a
a
a
a
a
a
a
a
a
a
a
a
a
a
a
a
a
a
a
a
a
a
a
a
a
a
a
a
a
a
"}
(2,1,1) = {"
a
d
d
d
d
d
d
d
d
d
d
d
d
d
d
d
d
d
d
d
d
d
d
d
d
d
d
d
d
a
"}
(3,1,1) = {"
a
d
e
e
e
e
e
e
e
e
e
e
e
e
e
e
e
e
e
e
e
e
e
e
e
e
e
e
d
a
"}
(4,1,1) = {"
a
d
e
e
e
e
e
e
e
e
e
e
e
e
e
e
e
e
e
e
e
e
e
e
e
e
e
e
d
a
"}
(5,1,1) = {"
a
d
e
e
e
e
e
e
e
e
e
e
e
e
e
e
e
e
e
e
e
e
e
e
e
e
e
e
d
a
"}
(6,1,1) = {"
a
d
e
e
e
e
e
e
e
e
e
e
e
e
e
e
e
e
e
e
e
e
e
e
e
e
e
e
d
a
"}
(7,1,1) = {"
a
d
e
e
e
e
e
e
e
e
e
e
e
e
e
e
e
e
e
e
e
e
e
e
e
e
e
e
d
a
"}
(8,1,1) = {"
a
d
e
e
e
e
e
e
e
e
e
e
e
e
e
e
e
e
e
e
e
e
e
e
e
e
e
e
d
a
"}
(9,1,1) = {"
a
d
e
e
e
e
e
e
e
e
e
e
e
e
e
e
e
e
e
e
e
e
e
e
e
e
e
e
d
a
"}
(10,1,1) = {"
a
d
e
e
e
e
e
e
e
e
e
e
e
e
e
e
e
e
e
e
e
e
e
e
e
e
e
e
d
a
"}
(11,1,1) = {"
a
d
e
R
R
R
R
R
R
e
e
e
e
e
e
e
e
e
e
e
I
e
e
e
e
e
e
e
d
a
"}
(12,1,1) = {"
a
d
e
e
e
e
e
e
e
e
e
e
e
e
e
e
e
e
e
e
e
e
e
e
e
e
e
e
d
a
"}
(13,1,1) = {"
a
d
R
R
R
R
R
R
e
e
e
e
e
e
e
e
e
e
e
e
e
e
e
e
e
e
e
e
d
a
"}
(14,1,1) = {"
a
d
R
R
R
R
R
R
e
e
e
e
e
e
e
e
e
e
e
e
e
e
e
e
e
e
e
e
d
a
"}
(15,1,1) = {"
a
d
e
e
e
e
e
e
e
e
e
e
e
e
e
e
e
e
e
e
e
e
e
e
e
e
e
e
d
a
"}
(16,1,1) = {"
a
d
R
R
R
R
R
R
e
e
e
e
e
e
e
e
e
e
e
e
e
e
e
e
e
e
e
e
d
a
"}
(17,1,1) = {"
a
d
R
R
R
R
R
R
e
e
e
e
e
e
e
e
e
e
e
e
e
e
e
e
e
e
e
e
d
a
"}
(18,1,1) = {"
a
d
e
e
e
e
e
e
e
e
e
e
e
e
e
e
e
e
e
e
e
e
e
e
e
e
e
e
d
a
"}
(19,1,1) = {"
a
d
e
R
R
R
R
R
R
e
e
e
e
e
e
e
e
e
e
e
e
e
e
e
e
e
e
e
d
a
"}
(20,1,1) = {"
a
d
e
e
e
e
e
e
e
e
e
e
e
e
e
e
e
e
e
e
e
e
e
e
e
e
e
e
d
a
"}
(21,1,1) = {"
a
d
e
e
e
e
e
e
e
e
e
e
e
e
e
e
e
e
e
e
e
e
e
e
e
e
e
e
d
a
"}
(22,1,1) = {"
a
d
e
e
e
e
e
e
e
e
e
e
e
e
e
e
e
e
e
e
e
e
e
e
e
e
e
e
d
a
"}
(23,1,1) = {"
a
d
e
e
e
e
e
e
e
e
e
e
e
e
e
e
e
e
e
e
e
e
e
e
e
e
e
e
d
a
"}
(24,1,1) = {"
a
d
e
e
e
e
e
e
e
e
e
e
e
e
e
e
e
e
e
e
e
e
e
e
e
e
e
e
d
a
"}
(25,1,1) = {"
a
d
e
e
e
e
e
e
e
e
e
e
e
e
e
e
e
e
e
e
e
e
e
e
e
e
e
e
d
a
"}
(26,1,1) = {"
a
d
e
e
e
e
e
e
e
e
e
e
e
e
e
e
e
e
e
e
e
e
e
e
e
e
e
e
d
a
"}
(27,1,1) = {"
a
d
e
e
e
e
e
e
e
e
e
e
e
e
e
e
e
e
e
e
e
e
e
e
e
e
e
e
d
a
"}
(28,1,1) = {"
a
d
e
e
e
e
e
e
e
e
e
e
e
e
e
e
e
e
e
e
e
e
e
e
e
e
e
e
d
a
"}
(29,1,1) = {"
a
d
d
d
d
d
d
d
d
d
d
d
d
d
d
d
d
d
d
d
d
d
d
d
d
d
d
d
d
a
"}
(30,1,1) = {"
a
a
a
a
a
a
a
a
a
a
a
a
a
a
a
a
a
a
a
a
a
a
a
a
a
a
a
a
a
a
"}
