//MAP CONVERTED BY dmm2tgm.py THIS HEADER COMMENT PREVENTS RECONVERSION, DO NOT REMOVE
"a" = (
/obj/storage/cart,
/obj/item/sheet/glass/reinforced{
	amount = 50
	},
/obj/item/sheet/steel/fullstack,
/turf/floor/plating,
/area/dmm_suite/clear_area)
"e" = (
/obj/storage/cart,
/obj/random_item_spawner/tools/few,
/turf/floor/plating,
/area/dmm_suite/clear_area)
"g" = (
/obj/machinery/portable_atmospherics/scrubber,
/turf/floor/plating,
/area/dmm_suite/clear_area)
"h" = (
/obj/machinery/light/small/floor/neutral,
/turf/floor/plating,
/area/dmm_suite/clear_area)
"u" = (
/obj/storage/closet/emergency,
/turf/floor/plating,
/area/dmm_suite/clear_area)
"y" = (
/obj/storage/crate,
/obj/random_item_spawner/tools/one_or_zero,
/turf/floor/plating,
/area/dmm_suite/clear_area)
"B" = (
/obj/storage/crate,
/obj/item/device/light/glowstick,
/obj/item/device/light/glowstick,
/obj/item/device/light/glowstick,
/obj/item/device/light/glowstick,
/obj/item/device/light/glowstick,
/obj/item/device/light/glowstick,
/obj/item/device/light/glowstick,
/obj/item/device/light/glowstick,
/obj/item/device/light/glowstick,
/obj/item/device/light/glowstick,
/obj/item/device/light/glowstick,
/obj/item/device/light/glowstick,
/obj/item/device/light/glowstick,
/obj/item/device/light/glowstick,
/obj/item/device/light/glowstick,
/obj/random_item_spawner/tools/one_or_zero,
/turf/floor/plating,
/area/dmm_suite/clear_area)
"U" = (
/turf/floor/plating,
/area/dmm_suite/clear_area)
"W" = (
/obj/random_item_spawner/tools/one_or_zero,
/obj/machinery/portable_atmospherics/canister/air,
/turf/floor/plating,
/area/dmm_suite/clear_area)

(1,1,1) = {"
g
e
U
a
u
"}
(2,1,1) = {"
U
h
U
h
U
"}
(3,1,1) = {"
W
u
U
y
B
"}
