//MAP CONVERTED BY dmm2tgm.py THIS HEADER COMMENT PREVENTS RECONVERSION, DO NOT REMOVE
"a" = (
/obj/decal/cleanable/dirt,
/obj/decal/cleanable/tracked_reagents/blood{
	icon_state = "bloodhit4"
	},
/obj/decal/cleanable/tracked_reagents/blood{
	icon_state = "drip1"
	},
/turf/floor/carpet/grime,
/area/dmm_suite/clear_area)
"h" = (
/obj/decal/cleanable/dirt,
/obj/item/reagent_containers/food/drinks/bottle/hobo_wine/safe,
/turf/floor/carpet/grime,
/area/dmm_suite/clear_area)
"j" = (
/obj/decal/cleanable/dirt,
/obj/stool/bed,
/obj/item/clothing/suit/bedsheet/random,
/obj/decal/cleanable/vomit,
/obj/decal/skeleton/decomposed_corpse{
	icon_state = "body6"
	},
/obj/decal/cleanable/tracked_reagents/blood{
	icon_state = "drip4d"
	},
/turf/floor/carpet/grime,
/area/dmm_suite/clear_area)
"k" = (
/obj/decal/cleanable/dirt,
/obj/decal/cleanable/tracked_reagents/blood{
	icon_state = "drip5a"
	},
/obj/decal/cleanable/tracked_reagents/blood{
	icon_state = "drip2d"
	},
/turf/floor/carpet/grime,
/area/dmm_suite/clear_area)
"m" = (
/obj/decal/cleanable/dirt,
/obj/table/wood/auto,
/obj/item/storage/secure/ssafe{
	pixel_x = -28
	},
/obj/machinery/light/lamp{
	pixel_x = 1;
	pixel_y = 10
	},
/turf/floor/carpet/grime,
/area/dmm_suite/clear_area)
"t" = (
/obj/decal/cleanable/dirt,
/obj/decal/cleanable/vomit,
/turf/floor/carpet/grime,
/area/dmm_suite/clear_area)
"I" = (
/obj/decal/cleanable/dirt,
/obj/storage/closet/dresser/random,
/obj/item/reagent_containers/food/drinks/bottle/beer,
/obj/item/reagent_containers/food/drinks/bottle/beer,
/obj/item/reagent_containers/food/drinks/bottle/beer,
/obj/item/reagent_containers/food/drinks/bottle/beer,
/obj/item/reagent_containers/food/drinks/bottle/beer,
/obj/item/reagent_containers/food/drinks/bottle/beer,
/obj/item/reagent_containers/food/drinks/bottle/beer,
/turf/floor/carpet/grime,
/area/dmm_suite/clear_area)
"O" = (
/obj/decal/cleanable/dirt,
/obj/item/reagent_containers/food/drinks/bottle/cider,
/obj/stool/chair{
	dir = 1
	},
/turf/floor/carpet/grime,
/area/dmm_suite/clear_area)
"U" = (
/obj/decal/cleanable/dirt,
/turf/floor/carpet/grime,
/area/dmm_suite/clear_area)

(1,1,1) = {"
m
O
t
U
k
"}
(2,1,1) = {"
U
U
U
a
t
"}
(3,1,1) = {"
I
j
U
U
h
"}
