//MAP CONVERTED BY dmm2tgm.py THIS HEADER COMMENT PREVENTS RECONVERSION, DO NOT REMOVE
"a" = (
/turf/simulated/floor/specialroom/cafeteria,
/area/dmm_suite/clear_area)
"b" = (
/obj/stool/chair/yellow{
	dir = 4
	},
/obj/decal/cleanable/ketchup,
/turf/simulated/floor/specialroom/cafeteria,
/area/dmm_suite/clear_area)
"c" = (
/obj/decal/poster/wallsign/foodhole/nanoburg{
	pixel_y = 24
	},
/turf/simulated/floor/specialroom/cafeteria,
/area/dmm_suite/clear_area)
"f" = (
/obj/table/reinforced/auto,
/obj/item/reagent_containers/food/drinks/drinkingglass/random_style,
/turf/simulated/floor/specialroom/cafeteria,
/area/dmm_suite/clear_area)
"h" = (
/obj/decal/cleanable/dirt/dirt5,
/turf/simulated/floor/specialroom/cafeteria,
/area/dmm_suite/clear_area)
"i" = (
/obj/table/round,
/obj/item/shaker/ketchup,
/turf/simulated/floor/specialroom/cafeteria,
/area/dmm_suite/clear_area)
"j" = (
/obj/machinery/vending/cola/red{
	pixel_y = 12
	},
/turf/simulated/floor/specialroom/cafeteria,
/area/dmm_suite/clear_area)
"k" = (
/obj/stool/chair/yellow{
	dir = 4
	},
/obj/decal/cleanable/dirt/dirt3,
/turf/simulated/floor/specialroom/cafeteria,
/area/dmm_suite/clear_area)
"l" = (
/obj/stool/chair/yellow{
	dir = 8
	},
/obj/item/crushed_can,
/turf/simulated/floor/specialroom/cafeteria,
/area/dmm_suite/clear_area)
"m" = (
/obj/machinery/vending/pizza,
/turf/simulated/floor/specialroom/cafeteria,
/area/dmm_suite/clear_area)
"o" = (
/obj/table/reinforced/auto,
/obj/machinery/light/small/ceiling/harsh,
/turf/simulated/floor/specialroom/cafeteria,
/area/dmm_suite/clear_area)
"q" = (
/obj/table/round,
/obj/item/reagent_containers/food/drinks/cola/random,
/turf/simulated/floor/specialroom/cafeteria,
/area/dmm_suite/clear_area)
"s" = (
/obj/stool/chair/yellow{
	dir = 4
	},
/turf/simulated/floor/specialroom/cafeteria,
/area/dmm_suite/clear_area)
"u" = (
/obj/decal/cleanable/dirt/dirt2,
/turf/simulated/floor/specialroom/cafeteria,
/area/dmm_suite/clear_area)
"v" = (
/obj/machinery/light/small/neutral{
	dir = 1
	},
/turf/simulated/floor/specialroom/cafeteria,
/area/dmm_suite/clear_area)
"w" = (
/obj/decal/poster{
	pixel_y = 28
	},
/obj/machinery/light/small/neutral{
	dir = 1
	},
/turf/simulated/floor/specialroom/cafeteria,
/area/dmm_suite/clear_area)
"x" = (
/obj/stool/chair/yellow{
	dir = 8
	},
/turf/simulated/floor/specialroom/cafeteria,
/area/dmm_suite/clear_area)
"z" = (
/obj/table/reinforced/auto,
/obj/item/shaker/ketchup,
/obj/machinery/light/small/ceiling/harsh,
/turf/simulated/floor/specialroom/cafeteria,
/area/dmm_suite/clear_area)
"B" = (
/obj/stool/chair/yellow{
	dir = 4
	},
/obj/machinery/light/small/ceiling/harsh,
/turf/simulated/floor/specialroom/cafeteria,
/area/dmm_suite/clear_area)
"C" = (
/obj/table/reinforced/auto,
/turf/simulated/floor/specialroom/cafeteria,
/area/dmm_suite/clear_area)
"E" = (
/obj/stool/chair/yellow{
	dir = 8
	},
/obj/machinery/light/small/ceiling/harsh,
/turf/simulated/floor/specialroom/cafeteria,
/area/dmm_suite/clear_area)
"F" = (
/obj/stool/chair/yellow{
	dir = 4
	},
/obj/decal/cleanable/paper,
/obj/machinery/light/small/ceiling/harsh,
/turf/simulated/floor/specialroom/cafeteria,
/area/dmm_suite/clear_area)
"G" = (
/obj/machinery/light/small/ceiling/harsh,
/turf/simulated/floor/specialroom/cafeteria,
/area/dmm_suite/clear_area)
"H" = (
/obj/decal/cleanable/dirt/jen,
/turf/simulated/floor/specialroom/cafeteria,
/area/dmm_suite/clear_area)
"J" = (
/obj/decal/cleanable/dirt/jen,
/turf/simulated/floor/orange,
/area/dmm_suite/clear_area)
"K" = (
/obj/table/reinforced/auto,
/obj/item/platestack,
/turf/simulated/floor/specialroom/cafeteria,
/area/dmm_suite/clear_area)
"L" = (
/obj/table/reinforced/auto,
/obj/machinery/cashreg,
/turf/simulated/floor/specialroom/cafeteria,
/area/dmm_suite/clear_area)
"N" = (
/obj/decal/cleanable/dirt/dirt3,
/obj/machinery/light/small/ceiling/harsh,
/obj/machinery/camera{
	c_tag = "autotag";
	dir = 9;
	name = "autoname - SS13";
	pixel_x = 10;
	tag = ""
	},
/turf/simulated/floor/specialroom/cafeteria,
/area/dmm_suite/clear_area)
"O" = (
/obj/table/round,
/turf/simulated/floor/specialroom/cafeteria,
/area/dmm_suite/clear_area)
"S" = (
/obj/table/round,
/obj/item/shaker/mustard,
/turf/simulated/floor/specialroom/cafeteria,
/area/dmm_suite/clear_area)
"U" = (
/obj/decal/cleanable/dirt,
/turf/simulated/floor/orange,
/area/dmm_suite/clear_area)
"X" = (
/obj/machinery/food_display/nanoburg{
	pixel_y = 24
	},
/turf/simulated/floor/specialroom/cafeteria,
/area/dmm_suite/clear_area)
"Y" = (
/obj/decal/cleanable/eggsplat,
/obj/machinery/food_display/nanoburg{
	pixel_y = 24
	},
/turf/simulated/floor/specialroom/cafeteria,
/area/dmm_suite/clear_area)

(1,1,1) = {"
v
a
o
j
B
b
B
s
G
a
"}
(2,1,1) = {"
a
a
L
a
O
i
O
S
u
a
"}
(3,1,1) = {"
Y
h
K
a
O
O
O
O
a
a
"}
(4,1,1) = {"
a
a
o
a
E
x
E
x
G
a
"}
(5,1,1) = {"
c
a
f
a
a
H
a
a
H
J
"}
(6,1,1) = {"
a
a
L
a
a
a
a
a
H
U
"}
(7,1,1) = {"
X
a
z
a
F
s
B
k
G
a
"}
(8,1,1) = {"
C
a
C
a
S
O
O
O
H
a
"}
(9,1,1) = {"
m
a
a
a
O
q
i
O
a
a
"}
(10,1,1) = {"
w
a
N
a
E
x
E
l
G
a
"}
