//MAP CONVERTED BY dmm2tgm.py THIS HEADER COMMENT PREVENTS RECONVERSION, DO NOT REMOVE
"a" = (
/obj/decal/cleanable/tracked_reagents/blood{
	icon_state = "gib2"
	},
/obj/decal/skeleton/decomposed_corpse{
	icon_state = "clowncorpse"
	},
/obj/critter/spider/clown,
/turf/floor/carpet/arcade,
/area/dmm_suite/clear_area)
"n" = (
/obj/decal/cleanable/tracked_reagents/blood{
	icon_state = "bloodhit4"
	},
/turf/floor/carpet/arcade,
/area/dmm_suite/clear_area)
"s" = (
/obj/reagent_dispensers/heliumtank,
/turf/floor/carpet/arcade,
/area/dmm_suite/clear_area)
"t" = (
/obj/item/clothing/mask/clown_hat,
/obj/item/reagent_containers/food/snacks/pie/cream,
/turf/floor/carpet/arcade,
/area/dmm_suite/clear_area)
"u" = (
/obj/decal/cleanable/tracked_reagents/blood{
	icon_state = "bloodhit4"
	},
/obj/decal/cleanable/tracked_reagents/blood{
	icon_state = "drip2d"
	},
/turf/floor/carpet/arcade,
/area/dmm_suite/clear_area)
"F" = (
/obj/decal/cleanable/tracked_reagents/blood{
	icon_state = "floor7"
	},
/turf/floor/carpet/arcade,
/area/dmm_suite/clear_area)
"M" = (
/obj/item/instrument/bikehorn,
/obj/decal/cleanable/tracked_reagents/blood{
	icon_state = "bloodhit2"
	},
/turf/floor/carpet/arcade,
/area/dmm_suite/clear_area)
"W" = (
/turf/floor/carpet/arcade,
/area/dmm_suite/clear_area)

(1,1,1) = {"
M
W
s
"}
(2,1,1) = {"
a
F
W
"}
(3,1,1) = {"
n
t
u
"}
