"a" = (/obj/decal/cleanable/dirt/random,/turf/floor/grime,/area/dmm_suite/clear_area)
"j" = (/obj/storage/crate,/obj/random_item_spawner/shoe/one_or_zero,/obj/random_item_spawner/tools/maybe_few,/obj/decal/cleanable/rust/jen,/turf/floor/grime,/area/dmm_suite/clear_area)
"q" = (/obj/storage/crate/packing,/obj/random_item_spawner/junk/few,/turf/floor/grime,/area/dmm_suite/clear_area)
"D" = (/obj/storage/closet,/obj/random_item_spawner/furniture_parts/one_or_zero,/obj/decal/cleanable/rust,/turf/floor/grime,/area/dmm_suite/clear_area)
"E" = (/obj/storage/crate,/obj/random_item_spawner/circuitboards/maybe_few,/turf/floor/grime,/area/dmm_suite/clear_area)
"H" = (/obj/storage/crate,/obj/random_item_spawner/furniture_parts/one_or_zero,/turf/floor/grime,/area/dmm_suite/clear_area)
"M" = (/turf/floor/grime,/area/dmm_suite/clear_area)
"Y" = (/obj/decal/cleanable/rust/jen,/turf/floor/grime,/area/dmm_suite/clear_area)

(1,1,1) = {"
qaH
YME
jYD
"}
