//MAP CONVERTED BY dmm2tgm.py THIS HEADER COMMENT PREVENTS RECONVERSION, DO NOT REMOVE
"a" = (
/obj/decal/cleanable/dirt/random,
/turf/floor/plating/random,
/area/dmm_suite/clear_area)
"i" = (
/turf/floor/plating/random,
/area/dmm_suite/clear_area)
"G" = (
/obj/decal/cleanable/oil/streak,
/turf/floor/plating/random,
/area/dmm_suite/clear_area)
"I" = (
/obj/decal/cleanable/oil,
/obj/machinery/portable_atmospherics/canister/toxins,
/turf/floor/plating/random,
/area/dmm_suite/clear_area)

(1,1,1) = {"
i
I
a
"}
(2,1,1) = {"
a
i
i
"}
(3,1,1) = {"
G
i
I
"}
