//MAP CONVERTED BY dmm2tgm.py THIS HEADER COMMENT PREVENTS RECONVERSION, DO NOT REMOVE
"a" = (
/obj/item/gimmickbomb/butt,
/turf/floor/plating/random,
/area/dmm_suite/clear_area)
"x" = (
/turf/floor/plating/random,
/area/dmm_suite/clear_area)
"B" = (
/obj/reagent_dispensers/fueltank,
/turf/floor/plating/random,
/area/dmm_suite/clear_area)
"D" = (
/obj/item/pipebomb/bomb,
/obj/decal/cleanable/dirt/random,
/turf/floor/plating/random,
/area/dmm_suite/clear_area)
"G" = (
/obj/structure/barricade,
/turf/floor/plating/random,
/area/dmm_suite/clear_area)
"R" = (
/obj/item/reagent_containers/food/drinks/fueltank/napalm,
/obj/decal/cleanable/dirt/random,
/turf/floor/plating/random,
/area/dmm_suite/clear_area)
"V" = (
/obj/item/reagent_containers/food/drinks/fueltank,
/turf/floor/plating/random,
/area/dmm_suite/clear_area)
"Y" = (
/obj/decal/cleanable/dirt/random,
/obj/structure/barricade,
/turf/floor/plating/random,
/area/dmm_suite/clear_area)

(1,1,1) = {"
B
B
R
"}
(2,1,1) = {"
Y
D
G
"}
(3,1,1) = {"
V
x
a
"}
