//MAP CONVERTED BY dmm2tgm.py THIS HEADER COMMENT PREVENTS RECONVERSION, DO NOT REMOVE
"a" = (
/obj/decal/cleanable/dirt/random,
/obj/storage/crate/trench_loot/ore4,
/turf/floor/cautionblack,
/area/dmm_suite/clear_area)
"b" = (
/turf/floor/cautionblack,
/area/dmm_suite/clear_area)
"v" = (
/obj/decal/cleanable/dirt/random,
/turf/floor/cautionblack,
/area/dmm_suite/clear_area)
"G" = (
/obj/decal/cleanable/rust,
/obj/storage/crate/trench_loot/ore,
/turf/floor/cautionblack,
/area/dmm_suite/clear_area)
"Q" = (
/obj/decal/cleanable/dirt/random,
/obj/storage/crate/trench_loot/ore,
/turf/floor/cautionblack,
/area/dmm_suite/clear_area)
"R" = (
/obj/storage/crate/trench_loot/ore3,
/turf/floor/cautionblack,
/area/dmm_suite/clear_area)
"W" = (
/obj/decal/cleanable/dirt/random,
/obj/storage/crate/trench_loot/ore2,
/turf/floor/cautionblack,
/area/dmm_suite/clear_area)
"X" = (
/obj/storage/crate/trench_loot/ore,
/turf/floor/cautionblack,
/area/dmm_suite/clear_area)

(1,1,1) = {"
Q
v
a
"}
(2,1,1) = {"
b
b
G
"}
(3,1,1) = {"
X
W
R
"}
