"a" = (/obj/decal/cleanable/dirt/random,/obj/storage/crate/trench_loot/ore4,/turf/floor/orangeblack,/area/dmm_suite/clear_area)
"b" = (/turf/floor/orangeblack,/area/dmm_suite/clear_area)
"v" = (/obj/decal/cleanable/dirt/random,/turf/floor/orangeblack,/area/dmm_suite/clear_area)
"G" = (/obj/decal/cleanable/rust,/obj/storage/crate/trench_loot/ore,/turf/floor/orangeblack,/area/dmm_suite/clear_area)
"Q" = (/obj/decal/cleanable/dirt/random,/obj/storage/crate/trench_loot/ore,/turf/floor/orangeblack,/area/dmm_suite/clear_area)
"R" = (/obj/storage/crate/trench_loot/ore3,/turf/floor/orangeblack,/area/dmm_suite/clear_area)
"W" = (/obj/decal/cleanable/dirt/random,/obj/storage/crate/trench_loot/ore2,/turf/floor/orangeblack,/area/dmm_suite/clear_area)
"X" = (/obj/storage/crate/trench_loot/ore,/turf/floor/orangeblack,/area/dmm_suite/clear_area)

(1,1,1) = {"
QbX
vbW
aGR
"}
