"a" = (/obj/item/decoration/ashtray,/obj/decal/cleanable/dirt,/turf/simulated/floor/yellow/side,/area/space)
"c" = (/obj/item/cigbutt{pixel_x = -6; pixel_y = -11},/turf/simulated/floor/grime,/area/space)
"d" = (/obj/storage/secure/closet/fridge,/obj/item/reagent_containers/food/snacks/plant/lemon,/obj/item/reagent_containers/food/snacks/plant/lemon,/obj/item/reagent_containers/food/snacks/plant/lemon,/obj/item/reagent_containers/food/snacks/plant/lemon,/obj/item/reagent_containers/food/snacks/plant/lemon,/obj/item/reagent_containers/food/snacks/plant/lemon,/obj/item/reagent_containers/food/snacks/plant/lemon,/obj/item/reagent_containers/food/snacks/plant/lemon,/obj/item/reagent_containers/food/snacks/plant/lemon,/obj/item/reagent_containers/food/snacks/plant/lemon,/obj/item/reagent_containers/food/snacks/ingredient/sugar,/obj/item/reagent_containers/food/snacks/ingredient/sugar,/obj/item/reagent_containers/food/snacks/ingredient/sugar,/obj/item/reagent_containers/food/snacks/ingredient/sugar,/obj/decal/cleanable/generic,/obj/decal/cleanable/dirt,/turf/simulated/floor/yellow/side{dir = 1},/area/space)
"e" = (/obj/submachine/chef_sink{dir = 4},/obj/decal/poster/wallsign/chsc{pixel_x = -31; pixel_y = 17},/turf/simulated/floor/grime,/area/space)
"h" = (/obj/table/auto,/obj/machinery/glass_recycler{pixel_y = 2},/obj/decal/cleanable/dirt,/turf/simulated/floor/yellow/side{dir = 1},/area/space)
"i" = (/turf/simulated/floor/grime,/area/space)
"m" = (/obj/storage/secure/closet/fridge,/obj/item/reagent_containers/food/snacks/plant/lemon,/obj/item/reagent_containers/food/snacks/plant/lemon,/obj/item/reagent_containers/food/snacks/plant/lemon,/obj/item/reagent_containers/food/snacks/plant/lemon,/obj/item/reagent_containers/food/snacks/plant/lemon,/obj/item/reagent_containers/food/snacks/plant/lemon,/obj/item/reagent_containers/food/snacks/plant/lemon,/obj/item/reagent_containers/food/snacks/plant/lemon,/obj/item/reagent_containers/food/snacks/plant/lemon,/obj/item/reagent_containers/food/snacks/plant/lemon,/obj/item/reagent_containers/food/snacks/ingredient/sugar,/obj/item/reagent_containers/food/snacks/ingredient/sugar,/obj/item/reagent_containers/food/snacks/ingredient/sugar,/obj/item/reagent_containers/food/snacks/ingredient/sugar,/obj/decal/cleanable/dirt,/turf/simulated/floor/yellow/side{dir = 1},/area/space)
"q" = (/obj/decal/cleanable/dirt,/turf/simulated/floor/yellow/side,/area/space)
"v" = (/turf/simulated/floor/plating,/area/space)
"x" = (/obj/item/cigbutt{pixel_x = 6; pixel_y = 7},/obj/item/cigbutt{pixel_x = -3; pixel_y = -4},/obj/item/cigbutt{pixel_y = -9},/obj/item/cigbutt{pixel_x = -8},/obj/item/cigbutt{pixel_x = -9; pixel_y = 7},/turf/simulated/floor/grime,/area/space)
"y" = (/obj/stool,/obj/decal/cleanable/paper,/obj/item/cigbutt,/obj/item/cigbutt{pixel_x = 13; pixel_y = 11},/turf/simulated/floor/grime,/area/space)
"D" = (/obj/table/auto,/obj/item/storage/box/glassbox{pixel_x = -3; pixel_y = 9},/obj/item/storage/box/glassbox{pixel_x = 14; pixel_y = 9},/obj/item/storage/box/glassbox{pixel_x = 12},/obj/item/storage/box/glassbox{pixel_x = -4},/obj/decal/cleanable/dirt,/turf/simulated/floor/yellow/side{dir = 1},/area/space)
"M" = (/obj/machinery/cashreg,/obj/decal/cleanable/dirt,/turf/simulated/floor/yellow/side,/area/space)
"V" = (/obj/table/auto,/obj/item/reagent_containers/food/drinks/juicer{pixel_y = 7},/obj/decal/cleanable/fungus,/obj/decal/cleanable/dirt,/turf/simulated/floor/yellow/side{dir = 1},/area/space)
"Y" = (/obj/submachine/ice_cream_dispenser,/turf/simulated/floor/grime,/area/space)

(1,1,1) = {"
hdDVm
eciii
yxiYi
aqMvi
"}
