//MAP CONVERTED BY dmm2tgm.py THIS HEADER COMMENT PREVENTS RECONVERSION, DO NOT REMOVE
"a" = (
/obj/decal/cleanable/dirt,
/turf/floor/specialroom/bar,
/area/dmm_suite/clear_area)
"d" = (
/obj/decal/cleanable/dirt,
/obj/table/reinforced/bar/auto,
/obj/item/reagent_containers/food/drinks/juicer{
	pixel_y = 7
	},
/turf/floor/specialroom/bar,
/area/dmm_suite/clear_area)
"e" = (
/obj/decal/cleanable/dirt,
/obj/machinery/cashreg,
/turf/floor/specialroom/bar,
/area/dmm_suite/clear_area)
"g" = (
/obj/table/reinforced/bar/auto,
/obj/machinery/glass_recycler{
	pixel_y = 2
	},
/turf/floor/specialroom/bar,
/area/dmm_suite/clear_area)
"o" = (
/obj/decal/poster/wallsign/ritossign{
	pixel_x = -32
	},
/obj/decal/cleanable/dirt,
/turf/floor/specialroom/bar,
/area/dmm_suite/clear_area)
"q" = (
/turf/floor/specialroom/bar,
/area/dmm_suite/clear_area)
"s" = (
/obj/storage/secure/closet/fridge,
/obj/item/reagent_containers/food/snacks/plant/lemon/spawnable,
/obj/item/reagent_containers/food/snacks/plant/lemon/spawnable,
/obj/item/reagent_containers/food/snacks/plant/lemon/spawnable,
/obj/item/reagent_containers/food/snacks/plant/lime/spawnable,
/obj/item/reagent_containers/food/snacks/plant/lime/spawnable,
/obj/item/reagent_containers/food/snacks/plant/lime/spawnable,
/obj/item/reagent_containers/food/snacks/plant/orange,
/obj/item/reagent_containers/food/snacks/plant/orange,
/obj/item/reagent_containers/food/snacks/plant/orange,
/obj/item/reagent_containers/food/snacks/plant/lemon/spawnable,
/obj/item/reagent_containers/food/snacks/plant/lime/spawnable,
/obj/item/reagent_containers/food/snacks/plant/orange,
/obj/item/reagent_containers/food/snacks/plant/orange,
/obj/item/reagent_containers/food/snacks/plant/lime/spawnable,
/obj/item/reagent_containers/food/snacks/plant/lemon/spawnable,
/turf/floor/specialroom/bar,
/area/dmm_suite/clear_area)
"G" = (
/obj/decal/cleanable/dirt,
/obj/submachine/italian_ice_dispenser,
/turf/floor/specialroom/bar,
/area/dmm_suite/clear_area)
"O" = (
/turf/floor/plating,
/area/dmm_suite/clear_area)
"U" = (
/obj/item/reagent_containers/food/snacks/italian_ice_cup,
/obj/item/reagent_containers/food/snacks/italian_ice_cup,
/obj/item/reagent_containers/food/snacks/italian_ice_cup,
/obj/item/reagent_containers/food/snacks/italian_ice_cup,
/obj/item/reagent_containers/food/snacks/italian_ice_cup,
/obj/item/reagent_containers/food/snacks/italian_ice_cup,
/obj/item/reagent_containers/food/snacks/italian_ice_cup,
/obj/item/reagent_containers/food/snacks/italian_ice_cup,
/obj/item/reagent_containers/food/snacks/italian_ice_cup,
/obj/item/reagent_containers/food/snacks/italian_ice_cup,
/obj/item/reagent_containers/food/snacks/italian_ice_cup,
/obj/item/reagent_containers/food/snacks/italian_ice_cup,
/obj/item/reagent_containers/food/snacks/italian_ice_cup,
/obj/item/reagent_containers/food/snacks/italian_ice_cup,
/obj/item/reagent_containers/food/snacks/italian_ice_cup,
/obj/storage/crate,
/turf/floor/specialroom/bar,
/area/dmm_suite/clear_area)
"W" = (
/obj/table/reinforced/bar/auto,
/obj/item/reagent_containers/food/drinks/drinkingglass/pitcher,
/turf/floor/specialroom/bar,
/area/dmm_suite/clear_area)
"Z" = (
/obj/decal/poster/wallsign/ritossign{
	pixel_x = 32
	},
/turf/floor/specialroom/bar,
/area/dmm_suite/clear_area)

(1,1,1) = {"
U
a
s
o
"}
(2,1,1) = {"
d
q
q
e
"}
(3,1,1) = {"
W
q
q
a
"}
(4,1,1) = {"
g
q
a
O
"}
(5,1,1) = {"
G
q
a
Z
"}
