"a" = (/obj/decal/cleanable/dirt,/turf/simulated/bar,/area/space)
"d" = (/obj/decal/cleanable/dirt,/obj/table/reinforced/bar/auto,/obj/item/reagent_containers/food/drinks/juicer{pixel_y = 7},/turf/simulated/bar,/area/space)
"g" = (/obj/table/reinforced/bar/auto,/obj/machinery/glass_recycler{pixel_y = 2},/turf/simulated/bar,/area/space)
"o" = (/obj/decal/poster/wallsign/ritossign{pixel_x = -32},/obj/decal/cleanable/dirt,/turf/simulated/bar,/area/space)
"q" = (/turf/simulated/bar,/area/space)
"s" = (/obj/storage/secure/closet/fridge,/obj/item/reagent_containers/food/snacks/plant/lemon,/obj/item/reagent_containers/food/snacks/plant/lime,/obj/item/reagent_containers/food/snacks/plant/orange,/obj/item/reagent_containers/food/snacks/plant/apple,/obj/item/reagent_containers/food/snacks/plant/cherry,/obj/item/reagent_containers/food/snacks/plant/pear,/obj/item/reagent_containers/food/snacks/plant/pineapple,/turf/simulated/bar,/area/space)
"G" = (/obj/decal/cleanable/dirt,/obj/submachine/italian_ice_dispenser,/turf/simulated/bar,/area/space)
"U" = (/obj/item/reagent_containers/food/snacks/italian_ice_cup,/obj/item/reagent_containers/food/snacks/italian_ice_cup,/obj/item/reagent_containers/food/snacks/italian_ice_cup,/obj/item/reagent_containers/food/snacks/italian_ice_cup,/obj/item/reagent_containers/food/snacks/italian_ice_cup,/obj/item/reagent_containers/food/snacks/italian_ice_cup,/obj/item/reagent_containers/food/snacks/italian_ice_cup,/obj/item/reagent_containers/food/snacks/italian_ice_cup,/obj/item/reagent_containers/food/snacks/italian_ice_cup,/obj/item/reagent_containers/food/snacks/italian_ice_cup,/obj/item/reagent_containers/food/snacks/italian_ice_cup,/obj/item/reagent_containers/food/snacks/italian_ice_cup,/obj/storage/crate,/turf/simulated/bar,/area/space)
"W" = (/obj/machinery/chem_dispenser/soda,/obj/item/reagent_containers/food/drinks/drinkingglass/pitcher,/turf/simulated/bar,/area/space)
"Z" = (/obj/decal/poster/wallsign/ritossign{pixel_x = 32},/turf/simulated/bar,/area/space)

(1,1,1) = {"
UdWgG
aqqqq
sqqaa
oaaqZ
"}
