//MAP CONVERTED BY dmm2tgm.py THIS HEADER COMMENT PREVENTS RECONVERSION, DO NOT REMOVE
"as" = (
/obj/decal/cleanable/tracked_reagents/blood/splatter{
	icon_state = "gibbl2"
	},
/obj/decal/cleanable/dirt,
/turf/floor/plating,
/area/shuttle/escape/centcom/cogmap2)
"bl" = (
/obj/table/reinforced/auto,
/obj/item/storage/firstaid/regular,
/obj/item/storage/firstaid/regular,
/turf/floor/plating,
/area/shuttle/escape/centcom/cogmap2)
"bv" = (
/obj/item/storage/wall/medical{
	pixel_z = -1
	},
/turf/wall/auto/shuttle{
	icon_state = "12"
	},
/area/shuttle/escape/centcom/cogmap2)
"bw" = (
/turf/floor/plating/damaged1,
/area/shuttle/escape/centcom/cogmap2)
"dw" = (
/obj/decal/cleanable/machine_debris{
	icon_state = "gib7"
	},
/obj/decal/cleanable/oil,
/turf/floor/plating,
/area/shuttle/escape/centcom/cogmap2)
"eY" = (
/obj/grille/steel,
/obj/window/auto/reinforced,
/obj/machinery/shuttle/engine/heater{
	dir = 8;
	icon_state = "alt_heater-R"
	},
/turf/floor/plating,
/area/shuttle/escape/centcom/cogmap2)
"fa" = (
/obj/machinery/light/small/floor,
/turf/floor/plating,
/area/shuttle/escape/centcom/cogmap2)
"fC" = (
/obj/decal/cleanable/tracked_reagents/blood/splatter{
	icon_state = "floor2"
	},
/turf/floor/plating,
/area/shuttle/escape/centcom/cogmap2)
"hD" = (
/obj/stool/chair/comfy/shuttle/green{
	dir = 4
	},
/obj/decal/cleanable/tracked_reagents/blood/splatter{
	icon_state = "gibbl2"
	},
/turf/floor/plating/damaged1,
/area/shuttle/escape/centcom/cogmap2)
"ie" = (
/turf/floor/stairs{
	icon_state = "Stairs_wide"
	},
/area/centcom)
"ii" = (
/turf/wall/auto/shuttle{
	icon_state = "4"
	},
/area/shuttle/escape/centcom/cogmap2)
"ir" = (
/obj/decal/skeleton{
	desc = "Eugh, the stench is horrible!";
	icon = 'icons/misc/hstation.dmi';
	icon_state = "body1";
	name = "decomposed corpse";
	pixel_y = 4
	},
/obj/decal/cleanable/tracked_reagents/blood/splatter{
	icon_state = "floor2"
	},
/turf/floor/plating/damaged1,
/area/shuttle/escape/centcom/cogmap2)
"km" = (
/obj/stool/chair/comfy/shuttle/brown{
	dir = 4
	},
/obj/decal/cleanable/tracked_reagents/blood/splatter,
/turf/floor/plating,
/area/shuttle/escape/centcom/cogmap2)
"kK" = (
/obj/indestructible/shuttle_corner{
	dir = 4
	},
/turf/outdoors/grass,
/area/shuttle/escape/centcom/cogmap2)
"kS" = (
/obj/indestructible/shuttle_corner,
/turf/outdoors/grass,
/area/shuttle/escape/centcom/cogmap2)
"lu" = (
/obj/machinery/sleeper/compact{
	dir = 4
	},
/turf/floor/plating,
/area/shuttle/escape/centcom/cogmap2)
"mW" = (
/obj/decal/cleanable/robot_debris,
/turf/floor/plating,
/area/shuttle/escape/centcom/cogmap2)
"on" = (
/obj/indestructible/shuttle_corner{
	dir = 8
	},
/turf/outdoors/grass,
/area/shuttle/escape/centcom/cogmap2)
"oy" = (
/obj/stool/chair/comfy/shuttle/red{
	dir = 4
	},
/obj/decal/skeleton{
	desc = "Eugh, the stench is horrible!";
	icon = 'icons/misc/hstation.dmi';
	icon_state = "body1";
	name = "decomposed corpse";
	pixel_y = 4
	},
/obj/decal/cleanable/tracked_reagents/blood/splatter,
/obj/decal/cleanable/tracked_reagents/blood/splatter{
	icon_state = "gibbl2"
	},
/obj/decal/cleanable/dirt,
/turf/floor/plating,
/area/shuttle/escape/centcom/cogmap2)
"qi" = (
/obj/stool/chair/comfy/shuttle/red{
	dir = 4
	},
/turf/floor/plating/damaged3,
/area/shuttle/escape/centcom/cogmap2)
"qz" = (
/obj/stool/chair/comfy/shuttle{
	dir = 4
	},
/obj/machinery/light{
	dir = 1;
	pixel_y = 21
	},
/turf/floor/plating,
/area/shuttle/escape/centcom/cogmap2)
"rz" = (
/obj/lattice{
	dir = 9;
	icon_state = "lattice-dir"
	},
/turf/outdoors/grass,
/area/centcom/outside)
"rJ" = (
/obj/stool/chair/comfy/shuttle{
	dir = 4
	},
/turf/floor/void,
/area/shuttle/escape/centcom/cogmap2)
"sc" = (
/turf/floor/void,
/area/shuttle/escape/centcom/cogmap2)
"sy" = (
/obj/stool/chair/comfy/shuttle/red{
	dir = 4
	},
/obj/decal/cleanable/dirt,
/turf/floor/plating,
/area/shuttle/escape/centcom/cogmap2)
"tw" = (
/obj/machinery/shuttle/engine/propulsion{
	dir = 8;
	icon_state = "alt_propulsion"
	},
/turf/outdoors/grass,
/area/shuttle/escape/centcom/cogmap2)
"tS" = (
/obj/decal/cleanable/tracked_reagents/blood/splatter{
	icon_state = "gibbl2"
	},
/turf/floor/plating,
/area/shuttle/escape/centcom/cogmap2)
"tW" = (
/obj/grille/steel,
/obj/window/auto/reinforced,
/obj/machinery/shuttle/engine/heater{
	dir = 8;
	icon_state = "alt_heater-M"
	},
/turf/floor/plating,
/area/shuttle/escape/centcom/cogmap2)
"uP" = (
/obj/decal/cleanable/tracked_reagents/blood/splatter{
	icon_state = "floor2"
	},
/obj/decal/cleanable/dirt,
/turf/floor/plating/scorched,
/area/shuttle/escape/centcom/cogmap2)
"vX" = (
/turf/floor/plating/damaged2,
/area/shuttle/escape/centcom/cogmap2)
"wj" = (
/obj/stool/chair/comfy/shuttle{
	dir = 4
	},
/obj/decal/cleanable/vomit,
/turf/floor/plating,
/area/shuttle/escape/centcom/cogmap2)
"wA" = (
/turf/outdoors/grass,
/area/centcom/outside)
"wS" = (
/obj/item/storage/wall/emergency{
	pixel_y = 4;
	pixel_z = -5
	},
/turf/wall/auto/shuttle{
	icon_state = "13"
	},
/area/shuttle/escape/centcom/cogmap2)
"xH" = (
/obj/machinery/light/small/floor,
/turf/floor/plating/damaged2,
/area/shuttle/escape/centcom/cogmap2)
"xJ" = (
/obj/indestructible/invisible_block,
/turf/outdoors/grass,
/area/shuttle/escape/centcom/cogmap2)
"xT" = (
/obj/decal/cleanable/tracked_reagents/blood/splatter,
/turf/floor/plating/damaged1,
/area/shuttle/escape/centcom/cogmap2)
"yc" = (
/obj/stool/chair/comfy/shuttle{
	dir = 4
	},
/obj/decal/cleanable/dirt,
/turf/floor/plating/damaged1,
/area/shuttle/escape/centcom/cogmap2)
"yj" = (
/turf/outdoors/grass,
/area/shuttle/escape/centcom/cogmap2)
"zi" = (
/obj/stool/chair/comfy/shuttle/red{
	dir = 4
	},
/turf/floor/plating/damaged1,
/area/shuttle/escape/centcom/cogmap2)
"zX" = (
/turf/floor/stairs{
	dir = 1;
	icon_state = "Stairs2_wide"
	},
/area/centcom)
"Aq" = (
/turf/floor/plating/damaged3,
/area/shuttle/escape/centcom/cogmap2)
"CG" = (
/obj/machinery/light/small/floor,
/obj/decal/cleanable/tracked_reagents/blood/splatter{
	icon_state = "gibbl2"
	},
/turf/floor/plating,
/area/shuttle/escape/centcom/cogmap2)
"Da" = (
/obj/stool/chair/comfy/shuttle{
	dir = 4
	},
/turf/floor/plating,
/area/shuttle/escape/centcom/cogmap2)
"Db" = (
/turf/wall{
	icon = 'icons/misc/worlds.dmi';
	icon_state = "leadcap"
	},
/area/centcom)
"Dj" = (
/obj/machinery/door/airlock/pyro/external,
/turf/floor/plating,
/area/shuttle/escape/centcom/cogmap2)
"DG" = (
/turf/wall/auto/shuttle{
	icon_state = "13"
	},
/area/shuttle/escape/centcom/cogmap2)
"DY" = (
/obj/stool/chair/comfy/shuttle{
	dir = 4
	},
/obj/machinery/light,
/obj/decal/cleanable/dirt,
/turf/floor/plating/damaged3,
/area/shuttle/escape/centcom/cogmap2)
"Ex" = (
/obj/indestructible/shuttle_corner{
	dir = 1
	},
/turf/outdoors/grass,
/area/shuttle/escape/centcom/cogmap2)
"Fy" = (
/obj/machinery/door/airlock/pyro/medical{
	dir = 4;
	name = "First-Aid Station";
	opacity = 0
	},
/turf/floor/plating,
/area/shuttle/escape/centcom/cogmap2)
"FJ" = (
/obj/decal/cleanable/paper,
/turf/floor/void,
/area/shuttle/escape/centcom/cogmap2)
"Gp" = (
/turf/floor/stairs{
	dir = 1;
	icon_state = "Stairs_wide"
	},
/area/centcom)
"He" = (
/obj/table/auto,
/obj/random_item_spawner/med_kit,
/turf/floor/plating,
/area/shuttle/escape/centcom/cogmap2)
"Hp" = (
/turf/floor/stairs{
	icon_state = "Stairs2_wide"
	},
/area/centcom)
"HD" = (
/obj/decal/cleanable/tracked_reagents/blood/splatter,
/turf/floor/plating,
/area/shuttle/escape/centcom/cogmap2)
"HU" = (
/obj/decal/skeleton{
	desc = "Eugh, the stench is horrible!";
	icon = 'icons/misc/hstation.dmi';
	icon_state = "body3";
	name = "decomposed corpse"
	},
/obj/decal/cleanable/tracked_reagents/blood/splatter{
	icon_state = "gibbl2"
	},
/turf/floor/plating/damaged3,
/area/shuttle/escape/centcom/cogmap2)
"HX" = (
/obj/stool/chair/comfy/shuttle{
	dir = 4
	},
/obj/decal/cleanable/dirt,
/turf/floor/plating,
/area/shuttle/escape/centcom/cogmap2)
"If" = (
/obj/stool/chair/comfy/shuttle{
	dir = 4
	},
/turf/floor/plating/scorched,
/area/shuttle/escape/centcom/cogmap2)
"Ii" = (
/obj/decal/cleanable/dirt,
/turf/floor/plating/scorched,
/area/shuttle/escape/centcom/cogmap2)
"Jl" = (
/obj/stool/chair/comfy/shuttle{
	dir = 4
	},
/obj/decal/cleanable/dirt,
/turf/floor/plating/damaged3,
/area/shuttle/escape/centcom/cogmap2)
"Jz" = (
/obj/wingrille_spawn/auto,
/turf/floor/plating,
/area/shuttle/escape/centcom/cogmap2)
"Kv" = (
/obj/stool/chair/comfy/shuttle{
	dir = 4
	},
/turf/floor/plating/damaged2,
/area/shuttle/escape/centcom/cogmap2)
"KD" = (
/obj/decal/cleanable/tracked_reagents/blood/splatter{
	icon_state = "gibbl2"
	},
/obj/decal/cleanable/tracked_reagents/blood/splatter,
/obj/decal/cleanable/dirt,
/turf/floor/plating,
/area/shuttle/escape/centcom/cogmap2)
"KG" = (
/obj/table/reinforced/auto,
/obj/item/storage/toolbox/emergency,
/turf/floor/plating,
/area/shuttle/escape/centcom/cogmap2)
"Lt" = (
/turf/shuttle/wall/cockpit,
/area/shuttle/escape/centcom/cogmap2)
"LJ" = (
/obj/stool/chair/comfy/shuttle/brown{
	dir = 4
	},
/obj/decal/cleanable/dirt,
/turf/floor/plating/damaged1,
/area/shuttle/escape/centcom/cogmap2)
"LV" = (
/turf/wall{
	dir = 1;
	icon = 'icons/misc/worlds.dmi';
	icon_state = "leadcap"
	},
/area/centcom)
"Mw" = (
/turf/wall/auto/shuttle{
	icon_state = "14"
	},
/area/shuttle/escape/centcom/cogmap2)
"Om" = (
/obj/lattice{
	dir = 4;
	icon_state = "lattice-dir"
	},
/turf/outdoors/grass,
/area/centcom/outside)
"OG" = (
/obj/machinery/door/airlock/pyro/security{
	dir = 4;
	name = "Secure Transport";
	opacity = 0
	},
/turf/floor/plating,
/area/shuttle/escape/centcom/cogmap2)
"OT" = (
/turf/wall/auto/shuttle{
	icon_state = "15"
	},
/area/shuttle/escape/centcom/cogmap2)
"Pt" = (
/obj/stool/chair/comfy/shuttle/brown{
	dir = 4
	},
/obj/decal/skeleton{
	desc = "Eugh, the stench is horrible!";
	icon = 'icons/misc/hstation.dmi';
	icon_state = "body8";
	name = "decomposed corpse"
	},
/obj/decal/cleanable/tracked_reagents/blood/splatter,
/obj/decal/cleanable/vomit,
/turf/floor/plating/damaged1,
/area/shuttle/escape/centcom/cogmap2)
"Qj" = (
/obj/stool/chair/comfy/shuttle{
	dir = 4
	},
/turf/floor/plating/damaged3,
/area/shuttle/escape/centcom/cogmap2)
"RS" = (
/obj/indestructible/shuttle_corner{
	dir = 4
	},
/turf/floor/plating,
/area/shuttle/escape/centcom/cogmap2)
"Sh" = (
/obj/stool/chair/comfy/shuttle{
	dir = 4
	},
/obj/decal/cleanable/vomit,
/turf/floor/plating/damaged1,
/area/shuttle/escape/centcom/cogmap2)
"St" = (
/turf/wall/auto/shuttle{
	icon_state = "2"
	},
/area/shuttle/escape/centcom/cogmap2)
"Vb" = (
/obj/decal/cleanable/tracked_reagents/blood/splatter{
	icon_state = "gibbl2"
	},
/obj/decal/cleanable/tracked_reagents/blood/splatter{
	icon_state = "floor4"
	},
/obj/decal/cleanable/dirt,
/turf/floor/plating,
/area/shuttle/escape/centcom/cogmap2)
"Vr" = (
/obj/machinery/sleeper/compact{
	dir = 4
	},
/obj/decal/skeleton,
/obj/decal/cleanable/tracked_reagents/blood/splatter{
	icon_state = "gibbl2"
	},
/turf/floor/plating,
/area/shuttle/escape/centcom/cogmap2)
"Vt" = (
/obj/stool/chair/comfy/shuttle/green{
	dir = 4
	},
/turf/floor/plating/damaged3,
/area/shuttle/escape/centcom/cogmap2)
"VN" = (
/turf/wall/auto/shuttle{
	icon_state = "1"
	},
/area/shuttle/escape/centcom/cogmap2)
"WY" = (
/obj/indestructible/shuttle_corner{
	dir = 0
	},
/turf/floor/plating,
/area/shuttle/escape/centcom/cogmap2)
"Xc" = (
/obj/stool/chair/comfy/shuttle/brown{
	dir = 4
	},
/obj/decal/cleanable/dirt,
/turf/floor/plating,
/area/shuttle/escape/centcom/cogmap2)
"Xr" = (
/turf/wall/auto/shuttle{
	icon_state = "3"
	},
/area/shuttle/escape/centcom/cogmap2)
"XB" = (
/obj/machinery/computer/shuttle/embedded/east,
/obj/stool/chair/comfy/shuttle/pilot{
	dir = 4
	},
/obj/decal/cleanable/molten_item,
/turf/floor/plating/damaged3,
/area/shuttle/escape/centcom/cogmap2)
"XN" = (
/turf/wall/auto/shuttle{
	icon_state = "12"
	},
/area/shuttle/escape/centcom/cogmap2)
"XZ" = (
/obj/machinery/light/small/floor,
/obj/decal/cleanable/tracked_reagents/blood/splatter,
/turf/floor/plating,
/area/shuttle/escape/centcom/cogmap2)
"Yc" = (
/turf/floor/plating,
/area/shuttle/escape/centcom/cogmap2)
"YS" = (
/obj/critter/crunched,
/turf/floor/void,
/area/shuttle/escape/centcom/cogmap2)
"ZJ" = (
/obj/grille/steel,
/obj/window/auto/reinforced,
/obj/machinery/shuttle/engine/heater{
	dir = 8;
	icon_state = "alt_heater-L"
	},
/turf/floor/plating,
/area/shuttle/escape/centcom/cogmap2)
"ZN" = (
/obj/item/storage/wall/fire{
	pixel_z = -1
	},
/turf/wall/auto/shuttle{
	icon_state = "12"
	},
/area/shuttle/escape/centcom/cogmap2)

(1,1,1) = {"
wA
yj
tw
tw
tw
yj
yj
tw
tw
yj
wA
"}
(2,1,1) = {"
wA
kS
ZJ
tW
eY
sc
sc
tW
eY
kK
wA
"}
(3,1,1) = {"
tw
XN
lu
He
Vr
sc
sc
qi
zi
XN
tw
"}
(4,1,1) = {"
ii
bv
Vt
fa
hD
sc
sy
XZ
oy
XN
ii
"}
(5,1,1) = {"
Ex
OT
Xr
Fy
sc
YS
Xr
OG
Xr
OT
on
"}
(6,1,1) = {"
wA
ZN
Sh
HU
sc
sc
Da
as
wj
XN
wA
"}
(7,1,1) = {"
wA
Jz
yc
sc
sc
Da
Da
ir
Qj
Jz
wA
"}
(8,1,1) = {"
Db
wS
qz
FJ
St
Jz
VN
Aq
DY
Mw
LV
"}
(9,1,1) = {"
ie
Dj
KD
Yc
fC
Yc
mW
Yc
tS
Dj
zX
"}
(10,1,1) = {"
Hp
Dj
as
Vb
bw
xH
sc
vX
xT
Dj
Gp
"}
(11,1,1) = {"
Db
DG
HX
HX
Yc
sc
sc
Kv
Da
Mw
LV
"}
(12,1,1) = {"
wA
Jz
uP
Jl
rJ
YS
FJ
sc
Da
Jz
wA
"}
(13,1,1) = {"
wA
Jz
Ii
Ii
HX
sc
sc
sc
sc
sc
wA
"}
(14,1,1) = {"
wA
Mw
RS
If
Jl
HD
Da
sc
sc
sc
wA
"}
(15,1,1) = {"
wA
Ex
OT
Jz
Xr
dw
Xr
Jz
OT
on
wA
"}
(16,1,1) = {"
wA
rz
Jz
KG
Xc
CG
Pt
bl
Jz
rz
wA
"}
(17,1,1) = {"
wA
Om
Ex
RS
LJ
XB
km
WY
on
Om
wA
"}
(18,1,1) = {"
wA
Om
wA
Ex
Xr
Xr
Xr
on
wA
Om
wA
"}
(19,1,1) = {"
wA
Om
wA
rz
xJ
Lt
xJ
rz
wA
Om
wA
"}
