//MAP CONVERTED BY dmm2tgm.py THIS HEADER COMMENT PREVENTS RECONVERSION, DO NOT REMOVE
"bl" = (
/obj/table/reinforced/auto,
/obj/item/storage/firstaid/regular,
/obj/item/storage/firstaid/regular,
/turf/floor/shuttle_noprotections,
/area/shuttle/escape/centcom/cogmap2)
"bv" = (
/obj/item/storage/wall/medical{
	pixel_z = -1
	},
/turf/wall/r_wall/shuttle_noprotections,
/area/shuttle/escape/centcom/cogmap2)
"dw" = (
/obj/machinery/door/airlock/pyro/glass/command{
	dir = 4
	},
/obj/access_spawn/heads,
/turf/floor/shuttle_noprotections,
/area/shuttle/escape/centcom/cogmap2)
"eY" = (
/obj/grille/steel,
/obj/window/auto/reinforced,
/obj/machinery/shuttle/engine/heater{
	dir = 8;
	icon_state = "alt_heater-R"
	},
/turf/floor/plating,
/area/shuttle/escape/centcom/cogmap2)
"fa" = (
/obj/machinery/light/small/floor,
/turf/floor/shuttle_noprotections{
	icon_state = "floor3"
	},
/area/shuttle/escape/centcom/cogmap2)
"ie" = (
/turf/floor/stairs{
	icon_state = "Stairs_wide"
	},
/area/centcom)
"kK" = (
/obj/indestructible/shuttle_corner{
	icon_state = "wall_trans"
	},
/turf/space,
/area/shuttle/escape/centcom/cogmap2)
"kS" = (
/obj/indestructible/shuttle_corner{
	dir = 8;
	icon_state = "wall_trans"
	},
/turf/space,
/area/shuttle/escape/centcom/cogmap2)
"lu" = (
/obj/machinery/sleeper/compact{
	dir = 4
	},
/turf/floor/shuttle_noprotections{
	icon_state = "floor3"
	},
/area/shuttle/escape/centcom/cogmap2)
"on" = (
/obj/indestructible/shuttle_corner{
	dir = 4;
	icon_state = "wall_trans"
	},
/turf/space,
/area/shuttle/escape/centcom/cogmap2)
"qz" = (
/obj/stool/chair/comfy/shuttle{
	dir = 4
	},
/obj/machinery/light{
	dir = 1;
	pixel_y = null
	},
/turf/floor/shuttle_noprotections,
/area/shuttle/escape/centcom/cogmap2)
"rz" = (
/obj/lattice{
	dir = 9;
	icon_state = "lattice-dir"
	},
/turf/space,
/area/space)
"sc" = (
/obj/stool/chair/comfy/shuttle/red{
	dir = 4
	},
/turf/floor/shuttle_noprotections{
	icon_state = "floor4"
	},
/area/shuttle/escape/centcom/cogmap2)
"sd" = (
/obj/stool/chair/comfy/shuttle{
	dir = 4
	},
/obj/machinery/light/small{
	dir = 4
	},
/turf/floor/shuttle_noprotections,
/area/shuttle/escape/centcom/cogmap2)
"tw" = (
/obj/machinery/shuttle/engine/propulsion{
	dir = 8;
	icon_state = "alt_propulsion"
	},
/turf/space,
/area/shuttle/escape/centcom/cogmap2)
"tW" = (
/obj/grille/steel,
/obj/window/auto/reinforced,
/obj/machinery/shuttle/engine/heater{
	dir = 8;
	icon_state = "alt_heater-M"
	},
/turf/floor/plating,
/area/shuttle/escape/centcom/cogmap2)
"wA" = (
/turf/space,
/area/space)
"wS" = (
/obj/item/storage/wall/emergency{
	pixel_y = 4;
	pixel_z = -5
	},
/turf/wall/r_wall/shuttle_noprotections,
/area/shuttle/escape/centcom/cogmap2)
"xJ" = (
/obj/indestructible/invisible_block,
/turf/space,
/area/shuttle/escape/centcom/cogmap2)
"yj" = (
/turf/space,
/area/shuttle/escape/centcom/cogmap2)
"zX" = (
/turf/floor/stairs{
	dir = 1;
	icon_state = "Stairs2_wide"
	},
/area/centcom)
"CG" = (
/obj/machinery/light/small/floor,
/turf/floor/shuttle_noprotections,
/area/shuttle/escape/centcom/cogmap2)
"Dj" = (
/obj/machinery/door/airlock/pyro/external/shuttle_connect,
/turf/floor/shuttle_noprotections,
/area/shuttle/escape/centcom/cogmap2)
"DY" = (
/obj/stool/chair/comfy/shuttle{
	dir = 4
	},
/obj/machinery/light,
/turf/floor/shuttle_noprotections,
/area/shuttle/escape/centcom/cogmap2)
"Ex" = (
/obj/indestructible/shuttle_corner{
	dir = 1;
	icon_state = "wall_trans"
	},
/turf/space,
/area/shuttle/escape/centcom/cogmap2)
"Fy" = (
/obj/machinery/door/airlock/pyro/medical{
	dir = 4;
	name = "First-Aid Station";
	opacity = 0
	},
/turf/floor/shuttle_noprotections{
	icon_state = "floor3"
	},
/area/shuttle/escape/centcom/cogmap2)
"Gp" = (
/turf/floor/stairs{
	dir = 1;
	icon_state = "Stairs_wide"
	},
/area/centcom)
"He" = (
/obj/table/auto,
/obj/random_item_spawner/med_kit,
/turf/floor/shuttle_noprotections{
	icon_state = "floor3"
	},
/area/shuttle/escape/centcom/cogmap2)
"Hp" = (
/turf/floor/stairs{
	icon_state = "Stairs2_wide"
	},
/area/centcom)
"Ii" = (
/obj/stool/chair/comfy/shuttle{
	dir = 4
	},
/obj/machinery/light/small/floor,
/turf/floor/shuttle_noprotections,
/area/shuttle/escape/centcom/cogmap2)
"Jz" = (
/obj/wingrille_spawn/reinforced,
/turf/floor/shuttle_noprotections{
	icon_state = "plating"
	},
/area/shuttle/escape/centcom/cogmap2)
"KD" = (
/turf/floor/shuttle_noprotections,
/area/shuttle/escape/centcom/cogmap2)
"KG" = (
/obj/table/reinforced/auto,
/obj/item/storage/toolbox/emergency,
/turf/floor/shuttle_noprotections,
/area/shuttle/escape/centcom/cogmap2)
"Lt" = (
/turf/shuttle/wall/cockpit{
	icon_state = "shuttlecock_busted"
	},
/area/shuttle/escape/centcom/cogmap2)
"LV" = (
/turf/wall/auto,
/area/centcom)
"Om" = (
/obj/lattice{
	dir = 4;
	icon_state = "lattice-dir"
	},
/turf/space,
/area/space)
"OG" = (
/obj/machinery/door/airlock/pyro/security{
	dir = 4;
	name = "Secure Transport";
	opacity = 0
	},
/obj/access_spawn/security,
/turf/floor/shuttle_noprotections{
	icon_state = "floor4"
	},
/area/shuttle/escape/centcom/cogmap2)
"RS" = (
/turf/wall/r_wall/shuttle_noprotections{
	icon_state = "wall_floor"
	},
/area/shuttle/escape/centcom/cogmap2)
"Sh" = (
/obj/stool/chair/comfy/shuttle{
	dir = 4
	},
/turf/floor/shuttle_noprotections,
/area/shuttle/escape/centcom/cogmap2)
"Vt" = (
/obj/stool/chair/comfy/shuttle/green{
	dir = 4
	},
/turf/floor/shuttle_noprotections{
	icon_state = "floor3"
	},
/area/shuttle/escape/centcom/cogmap2)
"WY" = (
/turf/wall/r_wall/shuttle_noprotections{
	dir = 8;
	icon_state = "wall_floor"
	},
/area/shuttle/escape/centcom/cogmap2)
"Xc" = (
/obj/stool/chair/comfy/shuttle/brown{
	dir = 4
	},
/turf/floor/shuttle_noprotections,
/area/shuttle/escape/centcom/cogmap2)
"Xr" = (
/turf/wall/auto/shuttle{
	icon_state = "3"
	},
/area/shuttle/escape/centcom/cogmap2)
"XB" = (
/obj/machinery/computer/shuttle/embedded/east,
/obj/stool/chair/comfy/shuttle/pilot{
	dir = 4
	},
/turf/floor/shuttle_noprotections,
/area/shuttle/escape/centcom/cogmap2)
"XZ" = (
/obj/machinery/light/small/floor,
/turf/floor/shuttle_noprotections{
	icon_state = "floor4"
	},
/area/shuttle/escape/centcom/cogmap2)
"YS" = (
/turf/wall/r_wall/shuttle_noprotections,
/area/shuttle/escape/centcom/cogmap2)
"ZJ" = (
/obj/grille/steel,
/obj/window/auto/reinforced,
/obj/machinery/shuttle/engine/heater{
	dir = 8;
	icon_state = "alt_heater-L"
	},
/turf/floor/plating,
/area/shuttle/escape/centcom/cogmap2)
"ZN" = (
/obj/item/storage/wall/fire{
	pixel_z = -1
	},
/turf/wall/r_wall/shuttle_noprotections,
/area/shuttle/escape/centcom/cogmap2)

(1,1,1) = {"
wA
yj
tw
tw
tw
yj
tw
tw
tw
yj
wA
"}
(2,1,1) = {"
wA
kS
ZJ
tW
eY
YS
ZJ
tW
eY
kK
wA
"}
(3,1,1) = {"
tw
YS
lu
He
lu
YS
sc
sc
sc
YS
tw
"}
(4,1,1) = {"
YS
bv
Vt
fa
Vt
YS
sc
XZ
sc
YS
YS
"}
(5,1,1) = {"
Ex
YS
YS
Fy
YS
YS
YS
OG
YS
YS
on
"}
(6,1,1) = {"
wA
ZN
Sh
KD
Sh
Sh
Sh
KD
Sh
YS
wA
"}
(7,1,1) = {"
wA
Jz
Sh
KD
Sh
Sh
Sh
KD
Sh
Jz
wA
"}
(8,1,1) = {"
LV
wS
qz
KD
YS
Jz
YS
KD
DY
YS
LV
"}
(9,1,1) = {"
ie
Dj
KD
KD
KD
KD
KD
KD
KD
Dj
zX
"}
(10,1,1) = {"
Hp
Dj
KD
KD
KD
CG
KD
KD
KD
Dj
Gp
"}
(11,1,1) = {"
LV
YS
Sh
Sh
KD
KD
KD
Sh
Sh
YS
LV
"}
(12,1,1) = {"
wA
Jz
Sh
Sh
Sh
KD
Sh
Sh
Sh
Jz
wA
"}
(13,1,1) = {"
wA
Jz
Sh
Ii
Sh
KD
Sh
Ii
Sh
Jz
wA
"}
(14,1,1) = {"
wA
YS
RS
Sh
sd
KD
sd
Sh
WY
YS
wA
"}
(15,1,1) = {"
wA
Ex
YS
Jz
YS
dw
YS
Jz
YS
on
wA
"}
(16,1,1) = {"
wA
rz
Jz
KG
Xc
CG
Xc
bl
Jz
rz
wA
"}
(17,1,1) = {"
wA
Om
Ex
RS
Xc
XB
Xc
WY
on
Om
wA
"}
(18,1,1) = {"
wA
Om
wA
Ex
Xr
Xr
Xr
on
wA
Om
wA
"}
(19,1,1) = {"
wA
Om
wA
rz
xJ
Lt
xJ
rz
wA
Om
wA
"}
