//MAP CONVERTED BY dmm2tgm.py THIS HEADER COMMENT PREVENTS RECONVERSION, DO NOT REMOVE
"aq" = (
/obj/decal/tile_edge/stripe/big,
/obj/decal/poster/wallsign/stencil/left/two,
/turf/space,
/area/space)
"aH" = (
/obj/decal/poster/wallsign/stencil/left/n{
	pixel_x = -13
	},
/obj/decal/tile_edge/stripe/big,
/turf/space,
/area/space)
"bj" = (
/obj/machinery/atmospherics/pipe/simple/overfloor/northeast,
/turf/space,
/area/space)
"bJ" = (
/obj/machinery/atmospherics/pipe/simple/color_pipe/yellow_pipe/overfloor/horizontal,
/turf/space,
/area/space)
"bV" = (
/obj/decal/tile_edge/stripe/big,
/turf/floor/shuttle_noprotections,
/area/space)
"cN" = (
/obj/decal/tile_edge/stripe/big,
/obj/decal/poster/wallsign/stencil/left/s{
	pixel_x = -28
	},
/turf/space,
/area/space)
"dH" = (
/obj/machinery/atmospherics/pipe/simple/insulated/northeast,
/turf/space,
/area/space)
"dI" = (
/obj/machinery/atmospherics/pipe/simple/insulated/cold/vertical,
/turf/space,
/area/space)
"fb" = (
/obj/machinery/atmospherics/pipe/simple/color_pipe/cyan_pipe/northeast,
/turf/space,
/area/space)
"gw" = (
/obj/machinery/atmospherics/pipe/simple/color_pipe/green_pipe/overfloor/southeast,
/turf/space,
/area/space)
"hq" = (
/obj/machinery/atmospherics/pipe/simple/overfloor/horizontal,
/turf/space,
/area/space)
"hL" = (
/obj/decal/poster/wallsign/stencil/left/c,
/obj/decal/poster/wallsign/stencil/right/o,
/obj/decal/tile_edge/stripe/big,
/turf/space,
/area/space)
"iA" = (
/obj/decal/poster/wallsign/stencil/left/s{
	pixel_x = -15
	},
/obj/decal/poster/wallsign/stencil/left/t,
/obj/decal/poster/wallsign/stencil/left/a{
	pixel_x = 9
	},
/obj/decal/tile_edge/stripe/big,
/turf/space,
/area/space)
"jL" = (
/obj/decal/poster/wallsign/stencil/left/d,
/obj/decal/tile_edge/stripe/big{
	dir = 1
	},
/turf/space,
/area/space)
"kz" = (
/obj/machinery/atmospherics/pipe/simple/color_pipe/cyan_pipe/overfloor/southwest,
/turf/space,
/area/space)
"kG" = (
/obj/machinery/atmospherics/pipe/simple/insulated/purge/northwest,
/turf/space,
/area/space)
"kK" = (
/obj/machinery/atmospherics/pipe/manifold/east,
/turf/space,
/area/space)
"le" = (
/obj/machinery/atmospherics/pipe/simple/insulated/southwest,
/turf/space,
/area/space)
"lo" = (
/obj/machinery/atmospherics/pipe/simple/overfloor/vertical,
/turf/space,
/area/space)
"lQ" = (
/obj/machinery/atmospherics/pipe/simple/insulated/purge/northeast,
/turf/space,
/area/space)
"mz" = (
/obj/decal/tile_edge/stripe/big,
/turf/space,
/area/space)
"mM" = (
/obj/machinery/atmospherics/pipe/simple/insulated/cold/northwest,
/turf/space,
/area/space)
"mV" = (
/obj/decal/poster/wallsign/stencil/left/u,
/obj/decal/tile_edge/stripe/big{
	dir = 1
	},
/turf/space,
/area/space)
"nw" = (
/obj/decal/poster/wallsign/stencil/left/n,
/turf/space,
/area/space)
"nU" = (
/obj/machinery/atmospherics/pipe/simple/color_pipe/green_pipe/overfloor/vertical,
/turf/space,
/area/space)
"oa" = (
/obj/machinery/atmospherics/pipe/simple/insulated/purge/southeast,
/turf/space,
/area/space)
"oY" = (
/obj/machinery/atmospherics/pipe/simple/color_pipe/green_pipe/overfloor/northeast,
/turf/space,
/area/space)
"pb" = (
/obj/machinery/atmospherics/pipe/simple/vertical,
/turf/space,
/area/space)
"pj" = (
/obj/machinery/atmospherics/pipe/simple/insulated/purge/southwest,
/turf/space,
/area/space)
"pI" = (
/obj/decal/poster/wallsign/stencil/left/r,
/obj/decal/tile_edge/stripe/big{
	dir = 1
	},
/turf/space,
/area/space)
"pO" = (
/obj/machinery/atmospherics/pipe/simple/color_pipe/green_pipe/southeast,
/turf/space,
/area/space)
"pS" = (
/obj/machinery/atmospherics/pipe/manifold/overfloor/west,
/turf/space,
/area/space)
"pU" = (
/obj/machinery/atmospherics/pipe/manifold/overfloor/north,
/turf/space,
/area/space)
"sd" = (
/obj/machinery/atmospherics/pipe/simple/color_pipe/cyan_pipe/southeast,
/turf/space,
/area/space)
"tU" = (
/obj/decal/tile_edge/stripe/big{
	dir = 1
	},
/obj/decal/poster/wallsign/stencil/left/v,
/turf/space,
/area/space)
"uu" = (
/obj/decal/tile_edge/stripe/big{
	dir = 1
	},
/obj/decal/poster/wallsign/stencil/left/o,
/turf/space,
/area/space)
"uB" = (
/obj/decal/poster/wallsign/stencil/left/i,
/turf/space,
/area/space)
"uS" = (
/obj/machinery/atmospherics/pipe/simple/overfloor/northwest,
/turf/space,
/area/space)
"uT" = (
/obj/decal/tile_edge/stripe/big{
	dir = 1
	},
/turf/floor/shuttle_noprotections,
/area/space)
"vi" = (
/obj/machinery/atmospherics/pipe/simple/color_pipe/yellow_pipe/southeast,
/turf/space,
/area/space)
"vv" = (
/obj/machinery/atmospherics/pipe/simple/color_pipe/green_pipe/horizontal,
/turf/space,
/area/space)
"vM" = (
/obj/decal/poster/wallsign/stencil/left/o{
	pixel_x = -8
	},
/obj/decal/poster/wallsign/stencil/left/l{
	pixel_x = 5
	},
/obj/decal/tile_edge/stripe/big,
/turf/space,
/area/space)
"xd" = (
/obj/machinery/atmospherics/pipe/simple/insulated/vertical,
/turf/space,
/area/space)
"xv" = (
/obj/machinery/atmospherics/pipe/simple/color_pipe/green_pipe/vertical,
/turf/space,
/area/space)
"yl" = (
/obj/machinery/atmospherics/pipe/manifold/overfloor/east,
/turf/space,
/area/space)
"yA" = (
/obj/machinery/atmospherics/pipe/simple/color_pipe/yellow_pipe/southwest,
/turf/space,
/area/space)
"yO" = (
/obj/machinery/atmospherics/pipe/simple/color_pipe/yellow_pipe/overfloor/northwest,
/turf/space,
/area/space)
"As" = (
/obj/machinery/atmospherics/pipe/simple/color_pipe/yellow_pipe/overfloor,
/turf/space,
/area/space)
"Ay" = (
/obj/machinery/atmospherics/pipe/simple/overfloor/southeast,
/turf/space,
/area/space)
"AI" = (
/obj/machinery/atmospherics/pipe/simple/insulated/northwest,
/turf/space,
/area/space)
"AX" = (
/obj/machinery/atmospherics/pipe/manifold/overfloor/south,
/turf/space,
/area/space)
"BB" = (
/obj/machinery/atmospherics/pipe/simple/color_pipe/cyan_pipe/overfloor/horizontal,
/turf/space,
/area/space)
"BU" = (
/obj/machinery/atmospherics/pipe/simple/insulated/cold/horizontal,
/turf/space,
/area/space)
"Cb" = (
/obj/machinery/atmospherics/pipe/simple/insulated/cold/southwest,
/turf/space,
/area/space)
"CP" = (
/obj/machinery/atmospherics/pipe/simple/insulated/southeast,
/turf/space,
/area/space)
"Ek" = (
/obj/machinery/atmospherics/pipe/simple/color_pipe/cyan_pipe/horizontal,
/turf/space,
/area/space)
"Eo" = (
/obj/decal/tile_edge/stripe/big{
	dir = 1
	},
/obj/decal/poster/wallsign/stencil/left/r,
/turf/space,
/area/space)
"FO" = (
/obj/machinery/atmospherics/pipe/simple/color_pipe/cyan_pipe/northwest,
/turf/space,
/area/space)
"FT" = (
/obj/machinery/atmospherics/pipe/simple/color_pipe/yellow_pipe/horizontal,
/turf/space,
/area/space)
"Go" = (
/obj/machinery/atmospherics/pipe/simple/color_pipe/cyan_pipe/overfloor/vertical,
/turf/space,
/area/space)
"GG" = (
/obj/decal/tile_edge/stripe/big,
/obj/decal/cleanable/writing{
	desc = "wackalope was here";
	name = "wackalope was here"
	},
/turf/space,
/area/space)
"Hc" = (
/obj/machinery/atmospherics/pipe/simple/color_pipe/green_pipe/overfloor,
/turf/space,
/area/space)
"Hd" = (
/obj/machinery/atmospherics/pipe/simple/color_pipe/yellow_pipe/northwest,
/turf/space,
/area/space)
"Hv" = (
/obj/machinery/atmospherics/pipe/simple/color_pipe/yellow_pipe/northeast,
/turf/space,
/area/space)
"Hw" = (
/obj/machinery/atmospherics/pipe/simple/insulated/cold/northeast,
/turf/space,
/area/space)
"Hy" = (
/obj/machinery/atmospherics/pipe/simple/color_pipe/cyan_pipe/overfloor/northeast,
/turf/space,
/area/space)
"HK" = (
/obj/decal/poster/wallsign/stencil/left/e,
/obj/decal/tile_edge/stripe/big{
	dir = 1
	},
/turf/space,
/area/space)
"HV" = (
/obj/machinery/atmospherics/pipe/simple/color_pipe/yellow_pipe/overfloor/vertical,
/turf/space,
/area/space)
"Ia" = (
/obj/machinery/atmospherics/pipe/simple/color_pipe/green_pipe/overfloor/horizontal,
/turf/space,
/area/space)
"IH" = (
/obj/decal/poster/wallsign/stencil/left/l,
/turf/space,
/area/space)
"Jr" = (
/obj/machinery/atmospherics/pipe/simple/insulated/cold/southeast,
/turf/space,
/area/space)
"KI" = (
/obj/decal/poster/wallsign/stencil/left/n,
/obj/decal/tile_edge/stripe/big{
	dir = 1
	},
/turf/space,
/area/space)
"Lh" = (
/obj/machinery/atmospherics/pipe/simple/insulated/purge/vertical,
/turf/space,
/area/space)
"Lo" = (
/obj/decal/tile_edge/stripe/big,
/obj/decal/poster/wallsign/stencil/left/zero{
	pixel_x = -22
	},
/obj/decal/poster/wallsign/stencil/left/two{
	pixel_x = -9
	},
/turf/space,
/area/space)
"LC" = (
/obj/machinery/atmospherics/pipe/simple/color_pipe/green_pipe/northeast,
/turf/space,
/area/space)
"LL" = (
/obj/decal/tile_edge/stripe/big{
	dir = 1
	},
/turf/space,
/area/space)
"LT" = (
/obj/machinery/atmospherics/pipe/simple/southwest,
/turf/space,
/area/space)
"LY" = (
/obj/machinery/atmospherics/pipe/simple/insulated/horizontal,
/turf/space,
/area/space)
"Mf" = (
/obj/machinery/atmospherics/pipe/manifold/south,
/turf/space,
/area/space)
"Mv" = (
/obj/decal/poster/wallsign/stencil/left/u,
/turf/space,
/area/space)
"Ne" = (
/turf/space,
/area/space)
"NN" = (
/obj/machinery/atmospherics/pipe/simple/color_pipe/cyan_pipe/overfloor/northwest,
/turf/space,
/area/space)
"Os" = (
/obj/machinery/atmospherics/pipe/simple/color_pipe/yellow_pipe/overfloor/southeast,
/turf/space,
/area/space)
"Ox" = (
/obj/machinery/atmospherics/pipe/simple/color_pipe/yellow_pipe/overfloor/southwest,
/turf/space,
/area/space)
"Qd" = (
/obj/machinery/atmospherics/pipe/simple/southeast,
/turf/space,
/area/space)
"QI" = (
/obj/machinery/atmospherics/pipe/simple/color_pipe/cyan_pipe/vertical,
/turf/space,
/area/space)
"Rl" = (
/obj/machinery/atmospherics/pipe/simple/insulated/purge/horizontal,
/turf/space,
/area/space)
"Rv" = (
/obj/machinery/atmospherics/pipe/simple/overfloor/southwest,
/turf/space,
/area/space)
"Rw" = (
/obj/machinery/atmospherics/pipe/simple/northeast,
/turf/space,
/area/space)
"RS" = (
/obj/decal/poster/wallsign/stencil/left/s,
/turf/space,
/area/space)
"Sw" = (
/obj/machinery/atmospherics/pipe/simple/color_pipe/green_pipe/overfloor/southwest,
/turf/space,
/area/space)
"Td" = (
/obj/machinery/atmospherics/pipe/simple/color_pipe/green_pipe/overfloor/northwest,
/turf/space,
/area/space)
"Tj" = (
/obj/machinery/atmospherics/pipe/simple/color_pipe/green_pipe/northwest,
/turf/space,
/area/space)
"Uo" = (
/obj/machinery/atmospherics/pipe/simple/color_pipe/cyan_pipe/southwest,
/turf/space,
/area/space)
"UP" = (
/obj/decal/tile_edge/stripe/big{
	dir = 1
	},
/obj/decal/cleanable/writing{
	desc = "coolstation";
	name = "coolstation"
	},
/turf/space,
/area/space)
"VU" = (
/obj/machinery/atmospherics/pipe/simple/color_pipe/cyan_pipe/overfloor/southeast,
/turf/space,
/area/space)
"WD" = (
/obj/decal/poster/wallsign/stencil/left/t{
	pixel_x = -11
	},
/obj/decal/poster/wallsign/stencil/left/i,
/obj/decal/poster/wallsign/stencil/left/o{
	pixel_x = 6
	},
/obj/decal/tile_edge/stripe/big,
/turf/space,
/area/space)
"WU" = (
/obj/machinery/atmospherics/pipe/simple/color_pipe/green_pipe/southwest,
/turf/space,
/area/space)
"Xd" = (
/obj/machinery/atmospherics/pipe/manifold/west,
/turf/space,
/area/space)
"Xj" = (
/obj/machinery/atmospherics/pipe/simple/color_pipe/yellow_pipe/overfloor/northeast,
/turf/space,
/area/space)
"Yi" = (
/obj/machinery/atmospherics/pipe/simple/color_pipe/yellow_pipe,
/turf/space,
/area/space)
"Za" = (
/obj/machinery/atmospherics/pipe/manifold/north,
/turf/space,
/area/space)
"Zf" = (
/obj/decal/tile_edge/stripe/big{
	dir = 1
	},
/obj/decal/poster/wallsign/stencil/left/e,
/turf/space,
/area/space)
"ZH" = (
/obj/machinery/atmospherics/pipe/simple/horizontal,
/turf/space,
/area/space)
"ZM" = (
/obj/machinery/atmospherics/pipe/simple/northwest,
/turf/space,
/area/space)
"ZP" = (
/turf/floor/shuttle_noprotections,
/area/space)

(1,1,1) = {"
LL
Ne
Ne
Ne
Ne
Ne
Ne
Ne
Ne
Ne
Ne
Ne
Ne
Ne
ZP
Ne
Jr
dI
Hw
hL
"}
(2,1,1) = {"
LL
Ne
Ne
Ne
Ne
Ne
Ne
Ne
gw
Hc
oY
Ne
Ne
Ne
ZP
Ne
BU
Ne
BU
vM
"}
(3,1,1) = {"
LL
Ne
Ne
Ne
Ne
Ne
Ne
Ne
Ia
Ne
Ia
Ne
Ne
Ne
ZP
uB
Cb
dI
mM
iA
"}
(4,1,1) = {"
LL
Ne
Ne
pS
Ne
Ay
lo
bj
Sw
nU
Td
Os
As
Xj
ZP
nw
CP
xd
dH
WD
"}
(5,1,1) = {"
uu
Ne
pU
Ne
AX
hq
Ne
hq
Ne
Ne
Ne
bJ
Ne
bJ
ZP
RS
LY
Ne
LY
aH
"}
(6,1,1) = {"
tU
Ne
Ne
yl
Ne
Rv
lo
uS
VU
Go
Hy
Ox
HV
yO
ZP
Mv
le
xd
AI
aq
"}
(7,1,1) = {"
Zf
Ne
Ne
Ne
Ne
Ne
Ne
Ne
BB
Ne
BB
Ne
Ne
Ne
ZP
IH
oa
Lh
lQ
Lo
"}
(8,1,1) = {"
Eo
Ne
Ne
Ne
Ne
Ne
Ne
Ne
kz
Go
NN
Ne
Ne
Ne
ZP
Ne
Rl
Ne
Rl
cN
"}
(9,1,1) = {"
LL
Ne
Ne
Ne
Ne
Ne
Ne
Ne
Ne
Ne
Ne
Ne
Ne
Ne
ZP
Ne
pj
Lh
kG
mz
"}
(10,1,1) = {"
uT
ZP
ZP
ZP
ZP
ZP
ZP
ZP
ZP
ZP
ZP
ZP
ZP
ZP
ZP
ZP
ZP
ZP
ZP
bV
"}
(11,1,1) = {"
uT
ZP
ZP
ZP
ZP
ZP
ZP
ZP
ZP
ZP
ZP
ZP
ZP
ZP
ZP
ZP
ZP
ZP
ZP
bV
"}
(12,1,1) = {"
LL
Ne
Ne
Ne
Ne
Ne
Ne
Ne
Ne
Ne
Ne
Ne
Ne
Ne
Ne
Ne
Ne
Ne
Ne
mz
"}
(13,1,1) = {"
mV
Ne
Ne
Ne
Ne
Ne
Ne
Ne
pO
xv
LC
Ne
Ne
Ne
Ne
Ne
Ne
ZP
Ne
mz
"}
(14,1,1) = {"
KI
Ne
Ne
Ne
Ne
Ne
Ne
Ne
vv
Ne
vv
Ne
Ne
Ne
Ne
ZP
Ne
Ne
ZP
mz
"}
(15,1,1) = {"
jL
Ne
Ne
Xd
Ne
Qd
pb
Rw
WU
xv
Tj
vi
Yi
Hv
Ne
Ne
Ne
Ne
ZP
mz
"}
(16,1,1) = {"
HK
Ne
Za
Ne
Mf
ZH
Ne
ZH
Ne
Ne
Ne
FT
Ne
FT
Ne
Ne
Ne
Ne
ZP
mz
"}
(17,1,1) = {"
pI
Ne
Ne
kK
Ne
LT
pb
ZM
sd
QI
fb
yA
Yi
Hd
Ne
Ne
Ne
Ne
ZP
mz
"}
(18,1,1) = {"
LL
Ne
Ne
Ne
Ne
Ne
Ne
Ne
Ek
Ne
Ek
Ne
Ne
Ne
Ne
ZP
Ne
Ne
ZP
mz
"}
(19,1,1) = {"
LL
Ne
Ne
Ne
Ne
Ne
Ne
Ne
Uo
QI
FO
Ne
Ne
Ne
Ne
Ne
Ne
ZP
Ne
mz
"}
(20,1,1) = {"
UP
Ne
Ne
Ne
Ne
Ne
Ne
Ne
Ne
Ne
Ne
Ne
Ne
Ne
Ne
Ne
Ne
Ne
Ne
GG
"}
