//MAP CONVERTED BY dmm2tgm.py THIS HEADER COMMENT PREVENTS RECONVERSION, DO NOT REMOVE
"az" = (
/obj/disposalpipe/segment/mail,
/obj/disposalpipe/segment/cargo{
	dir = 4
	},
/turf/floor/plating,
/area/space)
"aP" = (
/obj/disposalpipe/segment/mail{
	dir = 4;
	icon_state = "pipe-s"
	},
/turf/floor/plating,
/area/space)
"bV" = (
/turf/floor/red,
/area/space)
"dy" = (
/turf/space,
/area/space)
"dP" = (
/obj/disposalpipe/trunk{
	dir = 8
	},
/obj/disposaloutlet{
	dir = 8;
	name = "undeliverable mail outlet"
	},
/turf/floor/red,
/area/space)
"dV" = (
/obj/disposalpipe/junction/right/east,
/obj/disposalpipe/junction/right/east,
/turf/floor/plating,
/area/space)
"gE" = (
/obj/disposalpipe/switch_junction/left/north,
/turf/floor/red,
/area/space)
"gL" = (
/obj/disposalpipe/segment/mail,
/turf/floor/red,
/area/space)
"hf" = (
/obj/disposalpipe/trunk{
	dir = 8
	},
/obj/machinery/disposal/mail/autoname/janitor,
/turf/floor/plating,
/area/space)
"hs" = (
/obj/decal/poster/wallsign/stencil/left/o,
/obj/decal/poster/wallsign/stencil/right/p,
/turf/floor/red,
/area/space)
"kr" = (
/obj/decal/poster/wallsign/stencil/left/d,
/turf/floor/red,
/area/space)
"lk" = (
/obj/disposalpipe/trunk{
	dir = 8
	},
/obj/machinery/disposal/mail/autoname/checkpoint,
/turf/floor/plating,
/area/space)
"lD" = (
/obj/disposalpipe/trunk{
	dir = 8
	},
/obj/machinery/disposal/mail/autoname/kitchen,
/turf/floor/red,
/area/space)
"lF" = (
/obj/disposalpipe/trunk{
	dir = 8
	},
/obj/machinery/disposal/mail/autoname/qm,
/turf/floor/plating,
/area/space)
"nS" = (
/obj/disposalpipe/trunk,
/obj/machinery/disposal/mail/autoname/mining,
/turf/floor/red,
/area/space)
"nX" = (
/obj/disposalpipe/switch_junction/left/west,
/turf/floor/plating,
/area/space)
"of" = (
/obj/decal/poster/wallsign/stencil/right/o,
/obj/decal/poster/wallsign/stencil/left/c,
/turf/floor/plating,
/area/space)
"oE" = (
/obj/decal/poster/wallsign/stencil/left/l,
/obj/decal/poster/wallsign/stencil/right/o,
/turf/floor/red,
/area/space)
"oY" = (
/obj/decal/poster/wallsign/stencil/left/t,
/obj/decal/poster/wallsign/stencil/right/r,
/turf/floor/red,
/area/space)
"pV" = (
/obj/disposalpipe/segment/bent,
/turf/floor/plating,
/area/space)
"qs" = (
/obj/decal/tile_edge/floorguide/arrow_e,
/turf/floor/red,
/area/space)
"ra" = (
/obj/decal/poster/wallsign/stencil/left/e,
/obj/decal/poster/wallsign/stencil/right/e,
/turf/floor/red,
/area/space)
"rN" = (
/obj/disposalpipe/segment/mail{
	dir = 4;
	icon_state = "pipe-s"
	},
/turf/floor/scorched,
/area/space)
"rP" = (
/obj/disposalpipe/segment/bent{
	dir = 1
	},
/turf/floor/plating,
/area/space)
"rY" = (
/obj/disposalpipe/segment/bent{
	dir = 4
	},
/turf/floor/red,
/area/space)
"uh" = (
/obj/disposalpipe/trunk{
	dir = 8
	},
/obj/machinery/disposal/mail/autoname/mining,
/turf/floor/red,
/area/space)
"ul" = (
/obj/decal/poster/wallsign/stencil/left/b,
/turf/floor/red,
/area/space)
"vl" = (
/obj/decal/tile_edge/floorguide/arrow_n,
/turf/floor/red,
/area/space)
"vn" = (
/obj/disposalpipe/trunk,
/obj/machinery/disposal/mail/autoname/bridge,
/turf/floor/plating,
/area/space)
"wb" = (
/obj/disposalpipe/segment/mineral,
/turf/floor/plating,
/area/space)
"wi" = (
/obj/disposalpipe/switch_junction/left/south,
/turf/floor/red,
/area/space)
"wq" = (
/obj/disposalpipe/switch_junction/right/south,
/turf/floor/plating,
/area/space)
"yf" = (
/obj/decal/poster/wallsign/stencil/left/e,
/obj/decal/poster/wallsign/stencil/right/c,
/turf/floor/plating,
/area/space)
"yl" = (
/obj/disposalpipe/segment/bent,
/turf/floor/red,
/area/space)
"yJ" = (
/obj/disposalpipe/switch_junction/left/north,
/turf/floor/plating,
/area/space)
"zR" = (
/obj/disposalpipe/segment/configurator{
	dir = 4
	},
/turf/floor/plating,
/area/space)
"Bg" = (
/obj/disposalpipe/segment/configurator{
	dir = 4
	},
/turf/floor/scorched,
/area/space)
"Cu" = (
/obj/decal/cleanable/greenface,
/turf/floor/plating,
/area/space)
"CL" = (
/obj/disposalpipe/trunk{
	dir = 4
	},
/obj/machinery/disposal/mail/autoname/mechanics,
/turf/floor/plating,
/area/space)
"Dj" = (
/obj/decal/poster/wallsign/stencil/left/r,
/turf/floor/plating,
/area/space)
"DD" = (
/obj/disposalpipe/segment/bent{
	dir = 1
	},
/turf/floor/red,
/area/space)
"Eq" = (
/obj/decal/tile_edge/floorguide/arrow_w,
/turf/floor/red,
/area/space)
"Ev" = (
/obj/decal/poster/wallsign/stencil/left/s,
/turf/floor/red,
/area/space)
"EK" = (
/obj/disposalpipe/trunk{
	dir = 8
	},
/obj/machinery/disposal/mail/autoname/chapel,
/turf/floor/plating,
/area/space)
"EP" = (
/obj/disposalpipe/trunk{
	dir = 4
	},
/obj/machinery/disposal/mail/autoname/mining,
/turf/floor/red,
/area/space)
"EU" = (
/obj/disposalpipe/segment/cargo,
/turf/floor/plating,
/area/space)
"Fy" = (
/obj/disposalpipe/segment/bent{
	dir = 8
	},
/turf/floor/plating,
/area/space)
"Ge" = (
/obj/decal/poster/wallsign/stencil/left/o,
/turf/floor/plating,
/area/space)
"Gg" = (
/obj/disposalpipe/trunk{
	dir = 4
	},
/obj/machinery/disposal/mail/autoname/mining,
/turf/floor/plating,
/area/space)
"Gw" = (
/obj/decal/cleanable/ketchup,
/turf/floor/red,
/area/space)
"IW" = (
/obj/disposalpipe/trunk{
	dir = 8
	},
/obj/machinery/disposal/mail/autoname/qm,
/turf/floor/red,
/area/space)
"Js" = (
/turf/floor/scorched,
/area/space)
"JI" = (
/obj/disposalpipe/junction/right/east,
/turf/floor/plating,
/area/space)
"Km" = (
/obj/decal/poster/wallsign/stencil/left/l,
/obj/decal/poster/wallsign/stencil/right/l,
/turf/floor/plating,
/area/space)
"KE" = (
/obj/decal/poster/wallsign/stencil/left/t,
/obj/decal/poster/wallsign/stencil/right/o,
/turf/floor/plating,
/area/space)
"KV" = (
/turf/floor/plating,
/area/space)
"Lm" = (
/obj/decal/poster/wallsign/stencil/left/k,
/turf/floor/plating,
/area/space)
"Ls" = (
/obj/disposalpipe/segment/mail,
/obj/disposalpipe/segment/mineral{
	dir = 4
	},
/turf/floor/plating,
/area/space)
"MF" = (
/obj/disposalpipe/segment/configurator{
	dir = 4
	},
/turf/floor/red,
/area/space)
"MZ" = (
/obj/disposalpipe/switch_junction/right/east,
/turf/floor/red,
/area/space)
"Nm" = (
/obj/disposalpipe/segment/cargo{
	dir = 4
	},
/turf/floor/plating,
/area/space)
"Pk" = (
/obj/disposalpipe/trunk{
	dir = 1
	},
/obj/machinery/disposal/mail/autoname/qm,
/turf/floor/red,
/area/space)
"PA" = (
/obj/disposalpipe/trunk,
/obj/machinery/disposal/mail/autoname/chapel,
/turf/floor/plating,
/area/space)
"PH" = (
/obj/disposalpipe/segment/bent{
	dir = 4
	},
/turf/floor/plating,
/area/space)
"Qg" = (
/obj/disposalpipe/segment/mail,
/turf/floor/plating,
/area/space)
"QI" = (
/obj/disposalpipe/switch_junction/left/east,
/turf/floor/red,
/area/space)
"QW" = (
/obj/disposalpipe/switch_junction/right/east,
/turf/floor/plating,
/area/space)
"Sx" = (
/obj/decal/poster/wallsign/stencil/left/a,
/turf/floor/red,
/area/space)
"SG" = (
/obj/disposalpipe/switch_junction/left/south,
/turf/floor/plating,
/area/space)
"Tl" = (
/obj/disposalpipe/trunk{
	dir = 8
	},
/obj/disposaloutlet{
	dir = 8;
	name = "undeliverable mail outlet"
	},
/turf/floor/plating,
/area/space)
"TE" = (
/obj/disposalpipe/trunk,
/obj/machinery/disposal/mail/autoname/janitor,
/turf/floor/plating,
/area/space)
"Uq" = (
/obj/disposalpipe/segment/bent{
	dir = 8
	},
/turf/floor/red,
/area/space)
"Wb" = (
/obj/disposalpipe/trunk,
/obj/machinery/disposal/mail/autoname/checkpoint,
/turf/floor/plating,
/area/space)
"WX" = (
/obj/disposalpipe/segment/mineral{
	dir = 4
	},
/turf/floor/plating,
/area/space)
"ZG" = (
/obj/disposalpipe/junction/left/north,
/turf/floor/red,
/area/space)
"ZZ" = (
/obj/disposalpipe/segment/mail{
	dir = 4;
	icon_state = "pipe-s"
	},
/turf/floor/red,
/area/space)

(1,1,1) = {"
dy
dy
dy
dy
dy
dy
dy
dy
dy
dy
dy
dy
dy
dy
dy
dy
dy
dy
dy
dy
dy
dy
dy
dy
dy
dy
dy
dy
dy
dy
dy
dy
dy
dy
dy
dy
dy
dy
dy
dy
dy
dy
dy
dy
dy
dy
dy
dy
dy
dy
"}
(2,1,1) = {"
dy
dy
dy
dy
dy
dy
dy
dy
dy
dy
dy
dy
dy
dy
dy
dy
dy
dy
dy
dy
dy
dy
dy
dy
dy
dy
dy
dy
dy
dy
dy
dy
dy
dy
dy
dy
dy
dy
dy
dy
dy
dy
dy
dy
dy
dy
dy
dy
dy
dy
"}
(3,1,1) = {"
dy
dy
dy
dy
dy
dy
dy
dy
dy
dy
dy
dy
dy
dy
dy
dy
dy
dy
dy
dy
dy
dy
dy
dy
dy
dy
dy
dy
dy
dy
dy
dy
dy
dy
dy
dy
dy
dy
dy
dy
dy
dy
dy
dy
dy
dy
dy
dy
dy
dy
"}
(4,1,1) = {"
dy
dy
dy
dy
dy
dy
dy
dy
dy
dy
dy
dy
dy
dy
dy
dy
dy
dy
dy
dy
dy
dy
dy
dy
dy
dy
dy
dy
dy
dy
dy
dy
dy
dy
dy
dy
dy
dy
dy
dy
dy
dy
dy
dy
dy
dy
dy
dy
dy
dy
"}
(5,1,1) = {"
dy
dy
dy
dy
dy
dy
dy
dy
dy
dy
dy
dy
dy
dy
dy
dy
dy
dy
dy
dy
dy
dy
dy
dy
dy
dy
dy
dy
dy
dy
dy
dy
dy
dy
dy
dy
dy
dy
dy
dy
dy
dy
dy
dy
dy
dy
dy
dy
dy
dy
"}
(6,1,1) = {"
dy
dy
dy
dy
dy
dy
dy
dy
dy
dy
dy
dy
dy
dy
dy
dy
dy
dy
dy
dy
dy
dy
dy
dy
dy
dy
dy
dy
dy
dy
dy
dy
dy
dy
dy
dy
dy
dy
dy
dy
dy
dy
dy
dy
dy
dy
dy
dy
dy
dy
"}
(7,1,1) = {"
dy
dy
dy
dy
dy
dy
dy
dy
dy
dy
dy
dy
dy
dy
dy
dy
dy
dy
dy
dy
dy
dy
dy
dy
dy
dy
dy
dy
dy
dy
dy
dy
dy
dy
dy
dy
dy
dy
dy
dy
dy
dy
dy
dy
dy
dy
dy
dy
dy
dy
"}
(8,1,1) = {"
dy
dy
dy
dy
dy
dy
dy
dy
dy
dy
dy
dy
dy
dy
dy
dy
dy
dy
dy
dy
dy
dy
dy
dy
dy
dy
dy
dy
dy
dy
dy
dy
dy
dy
dy
dy
dy
dy
dy
dy
dy
dy
dy
dy
dy
dy
dy
dy
dy
dy
"}
(9,1,1) = {"
dy
dy
dy
dy
dy
dy
dy
dy
dy
dy
dy
dy
dy
dy
dy
dy
dy
dy
dy
dy
dy
dy
dy
dy
dy
dy
dy
dy
dy
dy
dy
dy
dy
dy
dy
dy
dy
dy
dy
dy
dy
dy
dy
dy
dy
dy
dy
dy
dy
dy
"}
(10,1,1) = {"
dy
dy
dy
dy
dy
dy
dy
dy
dy
dy
dy
dy
dy
dy
dy
dy
dy
dy
dy
dy
dy
dy
dy
dy
dy
dy
dy
dy
dy
dy
dy
dy
dy
dy
dy
dy
dy
dy
dy
dy
dy
dy
dy
dy
dy
dy
dy
dy
dy
dy
"}
(11,1,1) = {"
dy
dy
dy
dy
dy
dy
dy
dy
dy
dy
dy
dy
dy
dy
dy
dy
dy
dy
dy
dy
dy
dy
dy
dy
dy
dy
dy
dy
dy
dy
dy
dy
dy
dy
dy
dy
dy
dy
dy
dy
dy
dy
dy
dy
dy
dy
dy
dy
dy
dy
"}
(12,1,1) = {"
dy
dy
dy
dy
dy
dy
dy
dy
dy
dy
dy
dy
dy
dy
dy
dy
dy
dy
KV
KV
KV
KV
KV
KV
KV
KV
KV
KV
KV
KV
KV
KV
KV
KV
KV
bV
bV
bV
bV
bV
bV
bV
bV
bV
bV
bV
bV
bV
dy
dy
"}
(13,1,1) = {"
dy
dy
dy
dy
dy
dy
dy
dy
dy
dy
dy
dy
dy
dy
dy
dy
dy
dy
KV
KV
KV
KV
KV
KV
KV
KV
KV
KV
KV
KV
KV
KV
KV
KV
KV
bV
bV
bV
bV
bV
bV
bV
bV
bV
bV
bV
bV
bV
dy
dy
"}
(14,1,1) = {"
dy
dy
dy
dy
dy
dy
dy
dy
dy
dy
dy
dy
dy
dy
dy
dy
dy
dy
KV
KV
KV
KV
KV
KV
KV
KV
KV
KV
KV
KV
KV
KV
KV
KV
KV
bV
bV
bV
bV
bV
bV
bV
ZZ
bV
bV
bV
ZZ
bV
dy
dy
"}
(15,1,1) = {"
dy
dy
dy
dy
dy
dy
dy
dy
dy
dy
dy
dy
dy
dy
dy
dy
dy
dy
KV
KV
KV
KV
KV
KV
KV
KV
KV
KV
KV
KV
KV
KV
KV
KV
KV
bV
bV
bV
bV
bV
bV
bV
ZZ
bV
bV
Gw
MF
bV
dy
dy
"}
(16,1,1) = {"
dy
dy
dy
dy
dy
dy
dy
dy
dy
dy
dy
dy
dy
dy
dy
dy
dy
dy
KV
KV
KV
KV
KV
KV
KV
KV
CL
KV
Gg
KV
KV
KV
KV
KV
KV
bV
bV
bV
bV
bV
bV
bV
ZZ
bV
bV
bV
ZZ
bV
dy
dy
"}
(17,1,1) = {"
dy
dy
dy
dy
dy
dy
dy
dy
dy
dy
dy
dy
dy
dy
dy
dy
dy
dy
KV
KV
KV
KV
KV
KV
KV
KV
WX
KV
WX
KV
KV
KV
KV
KV
KV
bV
bV
bV
bV
bV
bV
bV
yl
gL
gE
gL
MZ
bV
dy
dy
"}
(18,1,1) = {"
dy
dy
dy
dy
dy
dy
dy
dy
dy
dy
dy
dy
dy
dy
dy
dy
dy
dy
KV
KV
KV
KV
KV
KV
KV
KV
WX
KV
WX
KV
KV
KV
KV
KV
KV
bV
bV
bV
bV
bV
bV
bV
bV
bV
ZZ
Gw
ZZ
bV
dy
dy
"}
(19,1,1) = {"
dy
dy
dy
dy
dy
dy
dy
dy
dy
dy
dy
dy
dy
dy
dy
dy
dy
dy
KV
KV
KV
KV
KV
PH
Qg
Qg
Ls
Qg
Ls
Qg
Qg
rP
KV
KV
KV
bV
bV
bV
bV
bV
EP
bV
bV
Gw
ZZ
bV
dP
bV
dy
dy
"}
(20,1,1) = {"
dy
dy
dy
dy
dy
dy
dy
dy
dy
dy
dy
dy
dy
dy
dy
dy
dy
dy
KV
KV
KV
KV
KV
aP
PH
wb
SG
wb
SG
wb
wb
dV
of
KV
KV
bV
bV
bV
bV
bV
ZZ
bV
bV
bV
ZZ
oY
bV
Gw
dy
dy
"}
(21,1,1) = {"
dy
dy
dy
dy
dy
dy
dy
dy
dy
dy
dy
dy
dy
dy
dy
dy
dy
dy
KV
KV
vn
Qg
Qg
nX
WX
KV
KV
PH
EU
wq
EU
JI
Km
KV
KV
bV
bV
bV
bV
rY
wi
DD
bV
bV
ZZ
ra
bV
bV
dy
dy
"}
(22,1,1) = {"
dy
dy
dy
dy
dy
dy
dy
dy
dy
dy
dy
dy
dy
dy
dy
dy
dy
dy
KV
KV
KV
KV
KV
aP
WX
PH
Qg
SG
Qg
az
Qg
JI
yf
KV
KV
bV
ul
bV
bV
ZZ
Gw
ZZ
nS
gL
MZ
Ev
bV
bV
dy
dy
"}
(23,1,1) = {"
dy
dy
dy
dy
dy
dy
dy
dy
dy
dy
dy
dy
dy
dy
dy
dy
dy
dy
KV
KV
PA
Qg
Qg
nX
WX
aP
KV
KV
KV
Nm
KV
aP
KE
KV
KV
bV
Sx
bV
bV
ZZ
bV
MF
bV
bV
ZZ
Gw
bV
bV
dy
dy
"}
(24,1,1) = {"
dy
dy
dy
dy
dy
dy
dy
dy
dy
dy
dy
dy
dy
dy
dy
dy
dy
dy
KV
KV
KV
KV
KV
aP
WX
aP
KV
Ge
KV
Nm
Js
rN
Dj
KV
KV
bV
kr
bV
bV
ZZ
bV
ZZ
bV
Gw
QI
gL
Pk
bV
dy
dy
"}
(25,1,1) = {"
dy
dy
dy
dy
dy
dy
dy
dy
dy
dy
dy
dy
dy
dy
dy
dy
dy
dy
KV
KV
Wb
Qg
Qg
nX
pV
nX
KV
Lm
KV
lF
Js
Bg
Js
KV
KV
bV
bV
bV
bV
yl
gE
Uq
bV
bV
ZZ
Gw
bV
bV
dy
dy
"}
(26,1,1) = {"
dy
dy
dy
dy
dy
dy
dy
dy
dy
dy
dy
dy
dy
dy
dy
dy
dy
dy
KV
KV
KV
KV
KV
aP
KV
aP
KV
Cu
KV
KV
Js
rN
Js
KV
KV
bV
bV
bV
bV
Gw
ZZ
Gw
bV
bV
lD
bV
bV
bV
dy
dy
"}
(27,1,1) = {"
dy
dy
dy
dy
dy
dy
dy
dy
dy
dy
dy
dy
dy
dy
dy
dy
dy
dy
KV
KV
TE
Qg
Qg
nX
KV
aP
KV
KV
KV
KV
KV
aP
KV
KV
KV
bV
bV
bV
bV
bV
IW
bV
bV
bV
bV
bV
bV
bV
dy
dy
"}
(28,1,1) = {"
dy
dy
dy
dy
dy
dy
dy
dy
dy
dy
dy
dy
dy
dy
dy
dy
dy
dy
KV
KV
KV
KV
KV
aP
KV
pV
Qg
yJ
Qg
Qg
Qg
QW
KV
KV
KV
bV
bV
bV
bV
bV
bV
bV
bV
bV
bV
bV
bV
bV
dy
dy
"}
(29,1,1) = {"
dy
dy
dy
dy
dy
dy
dy
dy
dy
dy
dy
dy
dy
dy
dy
dy
dy
dy
KV
KV
KV
KV
KV
pV
Qg
Qg
Qg
Fy
KV
KV
KV
aP
KV
KV
KV
bV
bV
bV
bV
bV
bV
bV
bV
bV
bV
bV
bV
bV
dy
dy
"}
(30,1,1) = {"
dy
dy
dy
dy
dy
dy
dy
dy
dy
dy
dy
dy
dy
dy
dy
dy
dy
dy
KV
KV
KV
KV
KV
KV
KV
KV
KV
KV
KV
KV
KV
aP
KV
KV
KV
bV
bV
bV
bV
bV
bV
bV
bV
bV
bV
ZZ
bV
bV
dy
dy
"}
(31,1,1) = {"
dy
dy
dy
dy
dy
dy
dy
dy
dy
dy
dy
dy
dy
dy
dy
dy
dy
dy
KV
KV
PH
Qg
Qg
Qg
Qg
Qg
Qg
Qg
rP
KV
KV
Tl
KV
KV
KV
bV
bV
bV
bV
bV
bV
bV
bV
bV
bV
MF
bV
bV
dy
dy
"}
(32,1,1) = {"
dy
dy
dy
dy
dy
dy
dy
dy
dy
dy
dy
dy
dy
dy
dy
dy
dy
dy
KV
KV
aP
KV
KV
KV
KV
KV
KV
KV
aP
KV
KV
KV
KV
KV
KV
bV
bV
bV
bV
bV
bV
Gw
bV
bV
bV
ZZ
bV
bV
dy
dy
"}
(33,1,1) = {"
dy
dy
dy
dy
dy
dy
dy
dy
dy
dy
dy
dy
dy
dy
dy
dy
dy
dy
KV
KV
aP
KV
KV
KV
KV
KV
Cu
KV
zR
KV
KV
KV
KV
KV
KV
bV
bV
bV
bV
gL
gE
gL
ZG
gL
gL
MZ
bV
bV
dy
dy
"}
(34,1,1) = {"
dy
dy
dy
dy
dy
dy
dy
dy
dy
dy
dy
dy
dy
dy
dy
dy
dy
dy
KV
KV
aP
KV
KV
KV
KV
KV
KV
KV
aP
KV
KV
KV
KV
KV
KV
bV
bV
bV
bV
qs
ZZ
oE
ZZ
vl
bV
ZZ
bV
bV
dy
dy
"}
(35,1,1) = {"
dy
dy
dy
dy
dy
dy
dy
dy
dy
dy
dy
dy
dy
dy
dy
dy
dy
dy
KV
KV
pV
Qg
yJ
Qg
yJ
Qg
yJ
Qg
QW
KV
KV
KV
KV
KV
KV
bV
bV
bV
Gw
bV
ZZ
hs
ZZ
bV
Gw
dP
bV
bV
dy
dy
"}
(36,1,1) = {"
dy
dy
dy
dy
dy
dy
dy
dy
dy
dy
dy
dy
dy
dy
dy
dy
dy
dy
KV
KV
KV
KV
EK
KV
lk
KV
hf
KV
aP
KV
KV
KV
KV
KV
KV
bV
bV
bV
bV
Gw
yl
gE
Uq
bV
bV
bV
bV
bV
dy
dy
"}
(37,1,1) = {"
dy
dy
dy
dy
dy
dy
dy
dy
dy
dy
dy
dy
dy
dy
dy
dy
dy
dy
KV
KV
KV
KV
KV
KV
KV
KV
KV
KV
Tl
KV
KV
KV
KV
KV
KV
bV
bV
bV
bV
bV
bV
ZZ
Eq
bV
bV
bV
bV
bV
dy
dy
"}
(38,1,1) = {"
dy
dy
dy
dy
dy
dy
dy
dy
dy
dy
dy
dy
dy
dy
dy
dy
dy
dy
KV
KV
KV
KV
KV
KV
KV
KV
KV
KV
KV
KV
KV
KV
KV
KV
KV
bV
bV
bV
bV
bV
bV
uh
bV
bV
bV
bV
bV
bV
dy
dy
"}
(39,1,1) = {"
dy
dy
dy
dy
dy
dy
dy
dy
dy
dy
dy
dy
dy
dy
dy
dy
dy
dy
dy
dy
dy
dy
dy
dy
dy
dy
dy
dy
dy
dy
dy
dy
dy
dy
dy
dy
dy
dy
dy
dy
dy
dy
dy
dy
dy
dy
dy
dy
dy
dy
"}
(40,1,1) = {"
dy
dy
dy
dy
dy
dy
dy
dy
dy
dy
dy
dy
dy
dy
dy
dy
dy
dy
dy
dy
dy
dy
dy
dy
dy
dy
dy
dy
dy
dy
dy
dy
dy
dy
dy
dy
dy
dy
dy
dy
dy
dy
dy
dy
dy
dy
dy
dy
dy
dy
"}
(41,1,1) = {"
dy
dy
dy
dy
dy
dy
dy
dy
dy
dy
dy
dy
dy
dy
dy
dy
dy
dy
dy
dy
dy
dy
dy
dy
dy
dy
dy
dy
dy
dy
dy
dy
dy
dy
dy
dy
dy
dy
dy
dy
dy
dy
dy
dy
dy
dy
dy
dy
dy
dy
"}
(42,1,1) = {"
dy
dy
dy
dy
dy
dy
dy
dy
dy
dy
dy
dy
dy
dy
dy
dy
dy
dy
dy
dy
dy
dy
dy
dy
dy
dy
dy
dy
dy
dy
dy
dy
dy
dy
dy
dy
dy
dy
dy
dy
dy
dy
dy
dy
dy
dy
dy
dy
dy
dy
"}
(43,1,1) = {"
dy
dy
dy
dy
dy
dy
dy
dy
dy
dy
dy
dy
dy
dy
dy
dy
dy
dy
dy
dy
dy
dy
dy
dy
dy
dy
dy
dy
dy
dy
dy
dy
dy
dy
dy
dy
dy
dy
dy
dy
dy
dy
dy
dy
dy
dy
dy
dy
dy
dy
"}
(44,1,1) = {"
dy
dy
dy
dy
dy
dy
dy
dy
dy
dy
dy
dy
dy
dy
dy
dy
dy
dy
dy
dy
dy
dy
dy
dy
dy
dy
dy
dy
dy
dy
dy
dy
dy
dy
dy
dy
dy
dy
dy
dy
dy
dy
dy
dy
dy
dy
dy
dy
dy
dy
"}
(45,1,1) = {"
dy
dy
dy
dy
dy
dy
dy
dy
dy
dy
dy
dy
dy
dy
dy
dy
dy
dy
dy
dy
dy
dy
dy
dy
dy
dy
dy
dy
dy
dy
dy
dy
dy
dy
dy
dy
dy
dy
dy
dy
dy
dy
dy
dy
dy
dy
dy
dy
dy
dy
"}
(46,1,1) = {"
dy
dy
dy
dy
dy
dy
dy
dy
dy
dy
dy
dy
dy
dy
dy
dy
dy
dy
dy
dy
dy
dy
dy
dy
dy
dy
dy
dy
dy
dy
dy
dy
dy
dy
dy
dy
dy
dy
dy
dy
dy
dy
dy
dy
dy
dy
dy
dy
dy
dy
"}
(47,1,1) = {"
dy
dy
dy
dy
dy
dy
dy
dy
dy
dy
dy
dy
dy
dy
dy
dy
dy
dy
dy
dy
dy
dy
dy
dy
dy
dy
dy
dy
dy
dy
dy
dy
dy
dy
dy
dy
dy
dy
dy
dy
dy
dy
dy
dy
dy
dy
dy
dy
dy
dy
"}
(48,1,1) = {"
dy
dy
dy
dy
dy
dy
dy
dy
dy
dy
dy
dy
dy
dy
dy
dy
dy
dy
dy
dy
dy
dy
dy
dy
dy
dy
dy
dy
dy
dy
dy
dy
dy
dy
dy
dy
dy
dy
dy
dy
dy
dy
dy
dy
dy
dy
dy
dy
dy
dy
"}
(49,1,1) = {"
dy
dy
dy
dy
dy
dy
dy
dy
dy
dy
dy
dy
dy
dy
dy
dy
dy
dy
dy
dy
dy
dy
dy
dy
dy
dy
dy
dy
dy
dy
dy
dy
dy
dy
dy
dy
dy
dy
dy
dy
dy
dy
dy
dy
dy
dy
dy
dy
dy
dy
"}
(50,1,1) = {"
dy
dy
dy
dy
dy
dy
dy
dy
dy
dy
dy
dy
dy
dy
dy
dy
dy
dy
dy
dy
dy
dy
dy
dy
dy
dy
dy
dy
dy
dy
dy
dy
dy
dy
dy
dy
dy
dy
dy
dy
dy
dy
dy
dy
dy
dy
dy
dy
dy
dy
"}
