//MAP CONVERTED BY dmm2tgm.py THIS HEADER COMMENT PREVENTS RECONVERSION, DO NOT REMOVE
"ab" = (
/obj/disposalpipe/segment/bent{
	dir = 4
	},
/turf/floor/plating,
/area/space)
"bx" = (
/obj/disposalpipe/trunk{
	dir = 4
	},
/obj/machinery/disposal/mail/autoname/mining,
/turf/floor/plating,
/area/space)
"bP" = (
/obj/decal/poster/wallsign/stencil/left/o,
/obj/decal/poster/wallsign/stencil/right/p,
/turf/floor/red,
/area/space)
"cc" = (
/obj/decal/tile_edge/floorguide/arrow_w,
/turf/floor/red,
/area/space)
"dl" = (
/obj/disposalpipe/segment/configurator{
	dir = 4
	},
/turf/floor/red,
/area/space)
"fc" = (
/obj/disposalpipe/junction/right/east,
/obj/disposalpipe/junction/right/east,
/turf/floor/plating,
/area/space)
"fl" = (
/obj/decal/tile_edge/floorguide/arrow_e,
/turf/floor/red,
/area/space)
"fF" = (
/obj/decal/cleanable/ketchup,
/turf/floor/red,
/area/space)
"hX" = (
/obj/disposalpipe/switch_junction/left/west,
/turf/floor/plating,
/area/space)
"iL" = (
/obj/decal/poster/wallsign/stencil/left/b,
/turf/floor/plating,
/area/space)
"iR" = (
/obj/disposalpipe/trunk{
	dir = 4
	},
/obj/machinery/disposal/mail/autoname/mining,
/turf/floor/red,
/area/space)
"kp" = (
/obj/decal/poster/wallsign/stencil/right/o,
/obj/decal/poster/wallsign/stencil/left/c,
/turf/floor/plating,
/area/space)
"kR" = (
/obj/disposalpipe/trunk{
	dir = 8
	},
/obj/machinery/disposal/mail/autoname/mining,
/turf/floor/red,
/area/space)
"lv" = (
/obj/disposalpipe/segment/bent,
/turf/floor/plating,
/area/space)
"lz" = (
/obj/disposalpipe/trunk{
	dir = 8
	},
/obj/disposaloutlet{
	dir = 8;
	name = "undeliverable mail outlet"
	},
/turf/floor/plating,
/area/space)
"lX" = (
/obj/decal/poster/wallsign/stencil/left/t,
/turf/floor/plating,
/area/space)
"ma" = (
/obj/disposalpipe/switch_junction/right/west,
/turf/floor/plating,
/area/space)
"mc" = (
/obj/disposalpipe/trunk{
	dir = 4
	},
/obj/machinery/disposal/mail/autoname/mechanics,
/turf/floor/plating,
/area/space)
"nj" = (
/obj/disposalpipe/switch_junction/left/north,
/turf/floor/red,
/area/space)
"nU" = (
/obj/decal/poster/wallsign/stencil/left/o,
/obj/decal/poster/wallsign/stencil/right/p,
/turf/floor/plating,
/area/space)
"oy" = (
/obj/disposalpipe/segment/mail{
	dir = 4;
	icon_state = "pipe-s"
	},
/turf/floor/scorched,
/area/space)
"oX" = (
/obj/decal/poster/wallsign/stencil/left/a,
/turf/floor/red,
/area/space)
"pe" = (
/obj/disposalpipe/trunk,
/obj/machinery/disposal/mail/autoname/janitor,
/turf/floor/plating,
/area/space)
"pV" = (
/obj/disposalpipe/switch_junction/left/south,
/turf/floor/plating,
/area/space)
"qj" = (
/obj/disposalpipe/segment/bent,
/turf/floor/red,
/area/space)
"qx" = (
/obj/decal/tile_edge/floorguide/arrow_s,
/turf/floor/plating,
/area/space)
"qz" = (
/obj/disposalpipe/segment/mail,
/obj/disposalpipe/segment/mineral{
	dir = 4
	},
/turf/floor/plating,
/area/space)
"qF" = (
/obj/disposalpipe/trunk{
	dir = 8
	},
/obj/machinery/disposal/mail/autoname/janitor,
/turf/floor/plating,
/area/space)
"qR" = (
/obj/decal/tile_edge/floorguide/arrow_e,
/turf/floor/plating,
/area/space)
"sM" = (
/obj/disposalpipe/switch_junction/left/east,
/turf/floor/plating,
/area/space)
"tP" = (
/obj/decal/poster/wallsign/stencil/left/s,
/turf/floor/red,
/area/space)
"vg" = (
/obj/decal/poster/wallsign/stencil/left/l,
/obj/decal/poster/wallsign/stencil/right/l,
/turf/floor/plating,
/area/space)
"vK" = (
/obj/disposalpipe/segment/bent{
	dir = 8
	},
/turf/floor/plating,
/area/space)
"wH" = (
/obj/disposalpipe/segment/cargo,
/turf/floor/plating,
/area/space)
"xp" = (
/turf/floor/plating,
/area/space)
"xr" = (
/obj/disposalpipe/segment/mail,
/turf/floor/plating,
/area/space)
"xu" = (
/obj/decal/poster/wallsign/stencil/left/o,
/obj/decal/poster/wallsign/stencil/right/r,
/turf/floor/plating,
/area/space)
"xC" = (
/obj/disposalpipe/trunk,
/obj/machinery/disposal/mail/autoname/mining,
/turf/floor/red,
/area/space)
"xT" = (
/obj/disposalpipe/segment/mail{
	dir = 4;
	icon_state = "pipe-s"
	},
/turf/floor/plating,
/area/space)
"yq" = (
/obj/disposalpipe/trunk{
	dir = 8
	},
/obj/disposaloutlet{
	dir = 8;
	name = "undeliverable mail outlet"
	},
/turf/floor/red,
/area/space)
"yS" = (
/obj/decal/poster/wallsign/stencil/left/b,
/turf/floor/red,
/area/space)
"yV" = (
/obj/decal/poster/wallsign/stencil/left/r,
/turf/floor/plating,
/area/space)
"zc" = (
/obj/disposalpipe/switch_junction/left/south,
/turf/floor/red,
/area/space)
"At" = (
/obj/disposalpipe/trunk{
	dir = 8
	},
/turf/floor/plating,
/area/space)
"AB" = (
/obj/disposalpipe/switch_junction/right/east,
/turf/floor/plating,
/area/space)
"Bs" = (
/obj/disposalpipe/segment/bent{
	dir = 4
	},
/turf/floor/red,
/area/space)
"BV" = (
/obj/decal/poster/wallsign/stencil/left/l,
/obj/decal/poster/wallsign/stencil/right/o,
/turf/floor/plating,
/area/space)
"CQ" = (
/turf/space,
/area/space)
"Dz" = (
/obj/decal/poster/wallsign/stencil/left/l,
/obj/decal/poster/wallsign/stencil/right/o,
/turf/floor/red,
/area/space)
"Eo" = (
/obj/disposalpipe/trunk{
	dir = 8
	},
/obj/machinery/disposal/mail/autoname/qm,
/turf/floor/plating,
/area/space)
"EX" = (
/obj/disposalpipe/trunk{
	dir = 1
	},
/obj/machinery/disposal/mail/autoname/qm,
/turf/floor/red,
/area/space)
"Fl" = (
/obj/decal/tile_edge/floorguide/arrow_w,
/turf/floor/plating,
/area/space)
"GP" = (
/obj/disposalpipe/segment/mineral,
/turf/floor/plating,
/area/space)
"Hm" = (
/obj/decal/poster/wallsign/stencil/left/e,
/obj/decal/poster/wallsign/stencil/right/e,
/turf/floor/red,
/area/space)
"Ie" = (
/obj/decal/tile_edge/floorguide/arrow_n,
/turf/floor/red,
/area/space)
"Iy" = (
/obj/disposalpipe/trunk,
/obj/machinery/disposal/mail/autoname/checkpoint,
/turf/floor/plating,
/area/space)
"IF" = (
/obj/disposalpipe/trunk,
/turf/floor/plating,
/area/space)
"IU" = (
/obj/disposalpipe/segment/mail,
/turf/floor/red,
/area/space)
"Jp" = (
/obj/decal/cleanable/gang_graffiti/greenface,
/turf/floor/plating,
/area/space)
"JL" = (
/obj/disposalpipe/trunk{
	dir = 8
	},
/obj/machinery/disposal/mail/autoname/qm,
/turf/floor/red,
/area/space)
"Ku" = (
/obj/decal/poster/wallsign/stencil/left/s,
/obj/decal/poster/wallsign/stencil/right/u,
/turf/floor/plating,
/area/space)
"KD" = (
/obj/disposalpipe/segment/mineral{
	dir = 4
	},
/turf/floor/plating,
/area/space)
"LM" = (
/obj/disposalpipe/trunk{
	dir = 4
	},
/turf/floor/plating,
/area/space)
"MB" = (
/obj/decal/poster/wallsign/stencil/left/k,
/turf/floor/plating,
/area/space)
"ML" = (
/obj/decal/poster/wallsign/stencil/left/s,
/obj/decal/poster/wallsign/stencil/right/h,
/turf/floor/plating,
/area/space)
"MO" = (
/obj/disposalpipe/segment/configurator{
	dir = 4
	},
/turf/floor/plating,
/area/space)
"MP" = (
/obj/disposalpipe/segment/bent{
	dir = 8
	},
/turf/floor/red,
/area/space)
"Nm" = (
/obj/disposalpipe/switch_junction/left/east,
/turf/floor/red,
/area/space)
"NC" = (
/obj/disposalpipe/segment/mail,
/obj/disposalpipe/segment/cargo{
	dir = 4
	},
/turf/floor/plating,
/area/space)
"NR" = (
/obj/decal/poster/wallsign/stencil/left/o,
/turf/floor/plating,
/area/space)
"Ox" = (
/obj/disposalpipe/segment/bent{
	dir = 1
	},
/turf/floor/red,
/area/space)
"Pz" = (
/obj/decal/poster/wallsign/stencil/left/d,
/turf/floor/red,
/area/space)
"Qc" = (
/obj/decal/poster/wallsign/stencil/left/t,
/obj/decal/poster/wallsign/stencil/right/r,
/turf/floor/red,
/area/space)
"Qw" = (
/obj/disposalpipe/trunk,
/obj/machinery/disposal/mail/autoname/bridge,
/turf/floor/plating,
/area/space)
"QA" = (
/obj/decal/poster/wallsign/stencil/left/c,
/obj/decal/poster/wallsign/stencil/right/u,
/turf/floor/plating,
/area/space)
"QS" = (
/obj/disposalpipe/trunk{
	dir = 1
	},
/turf/floor/plating,
/area/space)
"RD" = (
/obj/disposalpipe/segment/mail{
	dir = 4;
	icon_state = "pipe-s"
	},
/turf/floor/red,
/area/space)
"RF" = (
/obj/disposalpipe/trunk,
/obj/machinery/disposal/mail/autoname/chapel,
/turf/floor/plating,
/area/space)
"RX" = (
/obj/disposalpipe/switch_junction/right/east,
/turf/floor/red,
/area/space)
"SA" = (
/obj/disposalpipe/trunk{
	dir = 8
	},
/obj/machinery/disposal/mail/autoname/chapel,
/turf/floor/plating,
/area/space)
"TX" = (
/obj/decal/poster/wallsign/stencil/left/t,
/obj/decal/poster/wallsign/stencil/right/o,
/turf/floor/plating,
/area/space)
"Uv" = (
/obj/decal/poster/wallsign/stencil/left/s,
/turf/floor/plating,
/area/space)
"VU" = (
/obj/disposalpipe/segment/configurator{
	dir = 4
	},
/turf/floor/scorched,
/area/space)
"VV" = (
/obj/disposalpipe/trunk{
	dir = 8
	},
/obj/machinery/disposal/mail/autoname/checkpoint,
/turf/floor/plating,
/area/space)
"Wi" = (
/obj/decal/poster/wallsign/stencil/left/e,
/obj/decal/poster/wallsign/stencil/right/c,
/turf/floor/plating,
/area/space)
"WF" = (
/obj/disposalpipe/junction/right/east,
/turf/floor/plating,
/area/space)
"Xv" = (
/turf/floor/scorched,
/area/space)
"XY" = (
/obj/disposalpipe/trunk{
	dir = 8
	},
/obj/machinery/disposal/mail/autoname/kitchen,
/turf/floor/red,
/area/space)
"YN" = (
/turf/floor/red,
/area/space)
"Zp" = (
/obj/disposalpipe/segment/cargo{
	dir = 4
	},
/turf/floor/plating,
/area/space)
"Zw" = (
/obj/disposalpipe/switch_junction/right/south,
/turf/floor/plating,
/area/space)
"ZB" = (
/obj/disposalpipe/junction/left/north,
/turf/floor/red,
/area/space)
"ZI" = (
/obj/disposalpipe/segment/bent{
	dir = 1
	},
/turf/floor/plating,
/area/space)
"ZS" = (
/obj/disposalpipe/switch_junction/left/north,
/turf/floor/plating,
/area/space)

(1,1,1) = {"
CQ
CQ
CQ
CQ
CQ
CQ
CQ
CQ
CQ
CQ
CQ
CQ
CQ
CQ
CQ
CQ
CQ
CQ
CQ
CQ
CQ
CQ
CQ
CQ
CQ
CQ
CQ
CQ
CQ
CQ
CQ
CQ
CQ
CQ
CQ
CQ
CQ
CQ
CQ
CQ
CQ
CQ
CQ
CQ
CQ
CQ
CQ
CQ
CQ
CQ
"}
(2,1,1) = {"
CQ
CQ
CQ
CQ
CQ
CQ
CQ
CQ
CQ
CQ
CQ
CQ
CQ
CQ
CQ
CQ
CQ
CQ
CQ
CQ
CQ
CQ
CQ
CQ
CQ
CQ
CQ
CQ
CQ
CQ
CQ
CQ
CQ
CQ
CQ
CQ
CQ
CQ
CQ
CQ
CQ
CQ
CQ
CQ
CQ
CQ
CQ
CQ
CQ
CQ
"}
(3,1,1) = {"
CQ
CQ
CQ
CQ
CQ
CQ
CQ
CQ
CQ
CQ
CQ
CQ
CQ
CQ
CQ
CQ
CQ
CQ
CQ
CQ
CQ
CQ
CQ
CQ
CQ
CQ
CQ
CQ
CQ
CQ
CQ
CQ
CQ
CQ
CQ
CQ
CQ
CQ
CQ
CQ
CQ
CQ
CQ
CQ
CQ
CQ
CQ
CQ
CQ
CQ
"}
(4,1,1) = {"
CQ
CQ
CQ
CQ
CQ
CQ
CQ
CQ
CQ
CQ
CQ
CQ
CQ
CQ
CQ
CQ
CQ
CQ
CQ
CQ
CQ
CQ
CQ
CQ
CQ
CQ
CQ
CQ
CQ
CQ
CQ
CQ
CQ
CQ
CQ
CQ
CQ
CQ
CQ
CQ
CQ
CQ
CQ
CQ
CQ
CQ
CQ
CQ
CQ
CQ
"}
(5,1,1) = {"
CQ
CQ
CQ
CQ
CQ
CQ
CQ
CQ
CQ
CQ
CQ
CQ
CQ
CQ
CQ
CQ
CQ
CQ
CQ
CQ
CQ
CQ
CQ
CQ
CQ
CQ
CQ
CQ
CQ
CQ
CQ
CQ
CQ
CQ
CQ
CQ
CQ
CQ
CQ
CQ
CQ
CQ
CQ
CQ
CQ
CQ
CQ
CQ
CQ
CQ
"}
(6,1,1) = {"
CQ
CQ
CQ
CQ
CQ
CQ
CQ
CQ
CQ
CQ
CQ
CQ
CQ
CQ
CQ
CQ
CQ
CQ
CQ
CQ
CQ
CQ
CQ
CQ
CQ
CQ
CQ
CQ
CQ
CQ
CQ
CQ
CQ
CQ
CQ
CQ
CQ
CQ
CQ
CQ
CQ
CQ
CQ
CQ
CQ
CQ
CQ
CQ
CQ
CQ
"}
(7,1,1) = {"
CQ
CQ
CQ
CQ
CQ
CQ
CQ
CQ
CQ
CQ
CQ
CQ
CQ
CQ
CQ
CQ
CQ
CQ
CQ
CQ
CQ
CQ
CQ
CQ
CQ
CQ
CQ
CQ
CQ
CQ
CQ
CQ
CQ
CQ
CQ
CQ
CQ
CQ
CQ
CQ
CQ
CQ
CQ
CQ
CQ
CQ
CQ
CQ
CQ
CQ
"}
(8,1,1) = {"
CQ
CQ
CQ
CQ
CQ
CQ
CQ
CQ
CQ
CQ
CQ
CQ
CQ
CQ
CQ
CQ
CQ
CQ
CQ
CQ
CQ
CQ
CQ
CQ
CQ
CQ
CQ
CQ
CQ
CQ
CQ
CQ
CQ
CQ
CQ
CQ
CQ
CQ
CQ
CQ
CQ
CQ
CQ
CQ
CQ
CQ
CQ
CQ
CQ
CQ
"}
(9,1,1) = {"
CQ
CQ
CQ
CQ
CQ
CQ
CQ
CQ
CQ
CQ
CQ
CQ
CQ
CQ
CQ
CQ
CQ
CQ
CQ
CQ
CQ
CQ
CQ
CQ
CQ
CQ
CQ
CQ
CQ
CQ
CQ
CQ
CQ
CQ
CQ
CQ
CQ
CQ
CQ
CQ
CQ
CQ
CQ
CQ
CQ
CQ
CQ
CQ
CQ
CQ
"}
(10,1,1) = {"
CQ
CQ
CQ
CQ
CQ
CQ
CQ
CQ
CQ
CQ
CQ
CQ
CQ
CQ
CQ
CQ
CQ
CQ
CQ
CQ
CQ
CQ
CQ
CQ
CQ
CQ
CQ
CQ
CQ
CQ
CQ
CQ
CQ
CQ
CQ
CQ
CQ
CQ
CQ
CQ
CQ
CQ
CQ
CQ
CQ
CQ
CQ
CQ
CQ
CQ
"}
(11,1,1) = {"
CQ
CQ
CQ
CQ
CQ
CQ
CQ
CQ
CQ
CQ
CQ
CQ
CQ
CQ
CQ
CQ
CQ
CQ
CQ
CQ
CQ
CQ
CQ
CQ
CQ
CQ
CQ
CQ
CQ
CQ
CQ
CQ
CQ
CQ
CQ
CQ
CQ
CQ
CQ
CQ
CQ
CQ
CQ
CQ
CQ
CQ
CQ
CQ
CQ
CQ
"}
(12,1,1) = {"
CQ
CQ
CQ
CQ
CQ
CQ
CQ
CQ
CQ
CQ
xp
xp
xp
xp
xp
xp
xp
xp
xp
xp
xp
xp
xp
xp
xp
xp
xp
xp
xp
xp
xp
xp
xp
xp
xp
YN
YN
YN
YN
YN
YN
YN
YN
YN
YN
YN
YN
YN
CQ
CQ
"}
(13,1,1) = {"
CQ
CQ
CQ
CQ
CQ
CQ
CQ
CQ
CQ
CQ
xp
xp
xp
LM
LM
xp
xp
xp
xp
xp
xp
xp
xp
xp
xp
xp
xp
xp
xp
xp
xp
xp
xp
xp
xp
YN
YN
YN
YN
YN
YN
YN
YN
YN
YN
YN
YN
YN
CQ
CQ
"}
(14,1,1) = {"
CQ
CQ
CQ
CQ
CQ
CQ
CQ
CQ
CQ
CQ
xp
ab
xr
pV
pV
xr
ZI
xp
xp
xp
xp
xp
xp
xp
xp
xp
xp
xp
xp
xp
xp
xp
xp
xp
xp
YN
YN
YN
YN
YN
YN
YN
RD
YN
YN
YN
RD
YN
CQ
CQ
"}
(15,1,1) = {"
CQ
CQ
CQ
CQ
CQ
CQ
CQ
CQ
CQ
CQ
Fl
xT
xp
xp
xp
xp
xT
xp
xp
xp
xp
xp
Ku
xp
xp
xp
xp
xp
xp
xp
xp
xp
xp
xp
xp
YN
YN
YN
YN
YN
YN
YN
RD
YN
YN
fF
dl
YN
CQ
CQ
"}
(16,1,1) = {"
CQ
CQ
CQ
CQ
CQ
CQ
CQ
CQ
CQ
CQ
IF
hX
xp
xp
xp
xp
sM
QS
xp
xp
xp
xp
iL
xp
xp
xp
mc
xp
bx
xp
xp
xp
xp
xp
xp
YN
YN
YN
YN
YN
YN
YN
RD
YN
YN
YN
RD
YN
CQ
CQ
"}
(17,1,1) = {"
CQ
CQ
CQ
CQ
CQ
CQ
CQ
CQ
CQ
CQ
xp
xT
xp
xp
xp
xp
xT
xp
xp
xp
xp
xp
BV
xp
xp
xp
KD
xp
KD
xp
xp
xp
xp
xp
xp
YN
YN
YN
YN
YN
YN
YN
qj
IU
nj
IU
RX
YN
CQ
CQ
"}
(18,1,1) = {"
CQ
CQ
CQ
CQ
CQ
CQ
CQ
CQ
CQ
CQ
IF
hX
xp
xp
xp
xp
sM
QS
xp
xp
xp
xp
nU
xp
xp
xp
KD
xp
KD
xp
xp
xp
xp
xp
xp
YN
YN
YN
YN
YN
YN
YN
YN
YN
RD
fF
RD
YN
CQ
CQ
"}
(19,1,1) = {"
CQ
CQ
CQ
CQ
CQ
CQ
CQ
CQ
CQ
CQ
xp
xT
xp
LM
xp
qR
xT
xp
xp
xp
xp
xp
Uv
ab
xr
xr
qz
xr
qz
xr
xr
ZI
xp
xp
xp
YN
YN
YN
YN
YN
iR
YN
YN
fF
RD
YN
yq
YN
CQ
CQ
"}
(20,1,1) = {"
CQ
CQ
CQ
CQ
CQ
CQ
CQ
CQ
CQ
CQ
xp
ma
xr
pV
xr
xr
WF
xp
xp
xp
xp
xp
xp
xT
ab
GP
pV
GP
pV
GP
GP
fc
kp
xp
xp
YN
YN
YN
YN
YN
RD
YN
YN
YN
RD
Qc
YN
fF
CQ
CQ
"}
(21,1,1) = {"
CQ
CQ
CQ
CQ
CQ
CQ
CQ
CQ
CQ
CQ
Fl
xT
qx
ML
qx
xp
xT
xp
xp
xp
Qw
xr
xr
hX
KD
xp
xp
ab
wH
Zw
wH
WF
vg
xp
xp
YN
YN
YN
YN
Bs
zc
Ox
YN
YN
RD
Hm
YN
YN
CQ
CQ
"}
(22,1,1) = {"
CQ
CQ
CQ
CQ
CQ
CQ
CQ
CQ
CQ
CQ
IF
hX
xp
xu
xp
qR
sM
QS
xp
xp
xp
xp
xp
xT
KD
ab
xr
pV
xr
NC
xr
WF
Wi
xp
xp
YN
yS
YN
YN
RD
fF
RD
xC
IU
RX
tP
YN
YN
CQ
CQ
"}
(23,1,1) = {"
CQ
CQ
CQ
CQ
CQ
CQ
CQ
CQ
CQ
CQ
xp
xT
xp
lX
xp
xp
xT
xp
xp
xp
RF
xr
xr
hX
KD
xT
xp
xp
xp
Zp
xp
xT
TX
xp
xp
YN
oX
YN
YN
RD
YN
dl
YN
YN
RD
fF
YN
YN
CQ
CQ
"}
(24,1,1) = {"
CQ
CQ
CQ
CQ
CQ
CQ
CQ
CQ
CQ
CQ
IF
hX
xp
QA
xp
xp
MO
xp
xp
xp
xp
xp
xp
xT
KD
xT
xp
NR
xp
Zp
Xv
oy
yV
xp
xp
YN
Pz
YN
YN
RD
YN
RD
YN
fF
Nm
IU
EX
YN
CQ
CQ
"}
(25,1,1) = {"
CQ
CQ
CQ
CQ
CQ
CQ
CQ
CQ
CQ
CQ
xp
xT
xp
lX
xp
xp
xT
xp
xp
xp
Iy
xr
xr
hX
lv
hX
xp
MB
xp
Eo
Xv
VU
Xv
xp
xp
YN
YN
YN
YN
qj
nj
MP
YN
YN
RD
fF
YN
YN
CQ
CQ
"}
(26,1,1) = {"
CQ
CQ
CQ
CQ
CQ
CQ
CQ
CQ
CQ
CQ
IF
hX
xp
xp
xp
xp
xT
xp
xp
xp
xp
xp
xp
xT
xp
xT
xp
Jp
xp
xp
Xv
oy
Xv
xp
xp
YN
YN
YN
YN
fF
RD
fF
YN
YN
XY
YN
YN
YN
CQ
CQ
"}
(27,1,1) = {"
CQ
CQ
CQ
CQ
CQ
CQ
CQ
CQ
CQ
CQ
Fl
xT
xp
xp
xp
xp
xT
xp
xp
xp
pe
xr
xr
hX
xp
xT
xp
xp
xp
xp
xp
xT
xp
xp
xp
YN
YN
YN
YN
YN
JL
YN
YN
YN
YN
YN
YN
YN
CQ
CQ
"}
(28,1,1) = {"
CQ
CQ
CQ
CQ
CQ
CQ
CQ
CQ
CQ
CQ
xp
lv
ZS
xr
ZS
xr
AB
xp
xp
xp
xp
xp
xp
xT
xp
lv
xr
ZS
xr
xr
xr
AB
xp
xp
xp
YN
YN
YN
YN
YN
YN
YN
YN
YN
YN
YN
YN
YN
CQ
CQ
"}
(29,1,1) = {"
CQ
CQ
CQ
CQ
CQ
CQ
CQ
CQ
CQ
CQ
xp
xp
At
xp
At
xp
xT
xp
xp
xp
xp
xp
xp
lv
xr
xr
xr
vK
xp
xp
xp
xT
xp
xp
xp
YN
YN
YN
YN
YN
YN
YN
YN
YN
YN
YN
YN
YN
CQ
CQ
"}
(30,1,1) = {"
CQ
CQ
CQ
CQ
CQ
CQ
CQ
CQ
CQ
CQ
xp
xp
xp
xp
xp
xp
xT
xp
xp
xp
xp
xp
xp
xp
xp
xp
xp
xp
xp
xp
xp
xT
xp
xp
xp
YN
YN
YN
YN
YN
YN
YN
YN
YN
YN
RD
YN
YN
CQ
CQ
"}
(31,1,1) = {"
CQ
CQ
CQ
CQ
CQ
CQ
CQ
CQ
CQ
CQ
xp
xp
xp
xp
xp
xp
lz
xp
xp
xp
ab
xr
xr
xr
xr
xr
xr
xr
ZI
xp
xp
lz
xp
xp
xp
YN
YN
YN
YN
YN
YN
YN
YN
YN
YN
dl
YN
YN
CQ
CQ
"}
(32,1,1) = {"
CQ
CQ
CQ
CQ
CQ
CQ
CQ
CQ
CQ
CQ
xp
xp
xp
xp
xp
xp
xp
xp
xp
xp
xT
xp
xp
xp
xp
xp
xp
xp
xT
xp
xp
xp
xp
xp
xp
YN
YN
YN
YN
YN
YN
fF
YN
YN
YN
RD
YN
YN
CQ
CQ
"}
(33,1,1) = {"
CQ
CQ
CQ
CQ
CQ
CQ
CQ
CQ
CQ
CQ
xp
xp
xp
xp
xp
xp
xp
xp
xp
xp
xT
xp
xp
xp
xp
xp
Jp
xp
MO
xp
xp
xp
xp
xp
xp
YN
YN
YN
YN
IU
nj
IU
ZB
IU
IU
RX
YN
YN
CQ
CQ
"}
(34,1,1) = {"
CQ
CQ
CQ
CQ
CQ
CQ
CQ
CQ
CQ
CQ
xp
xp
xp
xp
xp
xp
xp
xp
xp
xp
xT
xp
xp
xp
xp
xp
xp
xp
xT
xp
xp
xp
xp
xp
xp
YN
YN
YN
YN
fl
RD
Dz
RD
Ie
YN
RD
YN
YN
CQ
CQ
"}
(35,1,1) = {"
CQ
CQ
CQ
CQ
CQ
CQ
CQ
CQ
CQ
CQ
xp
xp
xp
xp
xp
xp
xp
xp
xp
xp
lv
xr
ZS
xr
ZS
xr
ZS
xr
AB
xp
xp
xp
xp
xp
xp
YN
YN
YN
fF
YN
RD
bP
RD
YN
fF
yq
YN
YN
CQ
CQ
"}
(36,1,1) = {"
CQ
CQ
CQ
CQ
CQ
CQ
CQ
CQ
CQ
CQ
xp
xp
xp
xp
xp
xp
xp
xp
xp
xp
xp
xp
SA
xp
VV
xp
qF
xp
xT
xp
xp
xp
xp
xp
xp
YN
YN
YN
YN
fF
qj
nj
MP
YN
YN
YN
YN
YN
CQ
CQ
"}
(37,1,1) = {"
CQ
CQ
CQ
CQ
CQ
CQ
CQ
CQ
CQ
CQ
xp
xp
xp
xp
xp
xp
xp
xp
xp
xp
xp
xp
xp
xp
xp
xp
xp
xp
lz
xp
xp
xp
xp
xp
xp
YN
YN
YN
YN
YN
YN
RD
cc
YN
YN
YN
YN
YN
CQ
CQ
"}
(38,1,1) = {"
CQ
CQ
CQ
CQ
CQ
CQ
CQ
CQ
CQ
CQ
xp
xp
xp
xp
xp
xp
xp
xp
xp
xp
xp
xp
xp
xp
xp
xp
xp
xp
xp
xp
xp
xp
xp
xp
xp
YN
YN
YN
YN
YN
YN
kR
YN
YN
YN
YN
YN
YN
CQ
CQ
"}
(39,1,1) = {"
CQ
CQ
CQ
CQ
CQ
CQ
CQ
CQ
CQ
CQ
CQ
CQ
CQ
CQ
CQ
CQ
CQ
CQ
CQ
CQ
CQ
CQ
CQ
CQ
CQ
CQ
CQ
CQ
CQ
CQ
CQ
CQ
CQ
CQ
CQ
CQ
CQ
CQ
CQ
CQ
CQ
CQ
CQ
CQ
CQ
CQ
CQ
CQ
CQ
CQ
"}
(40,1,1) = {"
CQ
CQ
CQ
CQ
CQ
CQ
CQ
CQ
CQ
CQ
CQ
CQ
CQ
CQ
CQ
CQ
CQ
CQ
CQ
CQ
CQ
CQ
CQ
CQ
CQ
CQ
CQ
CQ
CQ
CQ
CQ
CQ
CQ
CQ
CQ
CQ
CQ
CQ
CQ
CQ
CQ
CQ
CQ
CQ
CQ
CQ
CQ
CQ
CQ
CQ
"}
(41,1,1) = {"
CQ
CQ
CQ
CQ
CQ
CQ
CQ
CQ
CQ
CQ
CQ
CQ
CQ
CQ
CQ
CQ
CQ
CQ
CQ
CQ
CQ
CQ
CQ
CQ
CQ
CQ
CQ
CQ
CQ
CQ
CQ
CQ
CQ
CQ
CQ
CQ
CQ
CQ
CQ
CQ
CQ
CQ
CQ
CQ
CQ
CQ
CQ
CQ
CQ
CQ
"}
(42,1,1) = {"
CQ
CQ
CQ
CQ
CQ
CQ
CQ
CQ
CQ
CQ
CQ
CQ
CQ
CQ
CQ
CQ
CQ
CQ
CQ
CQ
CQ
CQ
CQ
CQ
CQ
CQ
CQ
CQ
CQ
CQ
CQ
CQ
CQ
CQ
CQ
CQ
CQ
CQ
CQ
CQ
CQ
CQ
CQ
CQ
CQ
CQ
CQ
CQ
CQ
CQ
"}
(43,1,1) = {"
CQ
CQ
CQ
CQ
CQ
CQ
CQ
CQ
CQ
CQ
CQ
CQ
CQ
CQ
CQ
CQ
CQ
CQ
CQ
CQ
CQ
CQ
CQ
CQ
CQ
CQ
CQ
CQ
CQ
CQ
CQ
CQ
CQ
CQ
CQ
CQ
CQ
CQ
CQ
CQ
CQ
CQ
CQ
CQ
CQ
CQ
CQ
CQ
CQ
CQ
"}
(44,1,1) = {"
CQ
CQ
CQ
CQ
CQ
CQ
CQ
CQ
CQ
CQ
CQ
CQ
CQ
CQ
CQ
CQ
CQ
CQ
CQ
CQ
CQ
CQ
CQ
CQ
CQ
CQ
CQ
CQ
CQ
CQ
CQ
CQ
CQ
CQ
CQ
CQ
CQ
CQ
CQ
CQ
CQ
CQ
CQ
CQ
CQ
CQ
CQ
CQ
CQ
CQ
"}
(45,1,1) = {"
CQ
CQ
CQ
CQ
CQ
CQ
CQ
CQ
CQ
CQ
CQ
CQ
CQ
CQ
CQ
CQ
CQ
CQ
CQ
CQ
CQ
CQ
CQ
CQ
CQ
CQ
CQ
CQ
CQ
CQ
CQ
CQ
CQ
CQ
CQ
CQ
CQ
CQ
CQ
CQ
CQ
CQ
CQ
CQ
CQ
CQ
CQ
CQ
CQ
CQ
"}
(46,1,1) = {"
CQ
CQ
CQ
CQ
CQ
CQ
CQ
CQ
CQ
CQ
CQ
CQ
CQ
CQ
CQ
CQ
CQ
CQ
CQ
CQ
CQ
CQ
CQ
CQ
CQ
CQ
CQ
CQ
CQ
CQ
CQ
CQ
CQ
CQ
CQ
CQ
CQ
CQ
CQ
CQ
CQ
CQ
CQ
CQ
CQ
CQ
CQ
CQ
CQ
CQ
"}
(47,1,1) = {"
CQ
CQ
CQ
CQ
CQ
CQ
CQ
CQ
CQ
CQ
CQ
CQ
CQ
CQ
CQ
CQ
CQ
CQ
CQ
CQ
CQ
CQ
CQ
CQ
CQ
CQ
CQ
CQ
CQ
CQ
CQ
CQ
CQ
CQ
CQ
CQ
CQ
CQ
CQ
CQ
CQ
CQ
CQ
CQ
CQ
CQ
CQ
CQ
CQ
CQ
"}
(48,1,1) = {"
CQ
CQ
CQ
CQ
CQ
CQ
CQ
CQ
CQ
CQ
CQ
CQ
CQ
CQ
CQ
CQ
CQ
CQ
CQ
CQ
CQ
CQ
CQ
CQ
CQ
CQ
CQ
CQ
CQ
CQ
CQ
CQ
CQ
CQ
CQ
CQ
CQ
CQ
CQ
CQ
CQ
CQ
CQ
CQ
CQ
CQ
CQ
CQ
CQ
CQ
"}
(49,1,1) = {"
CQ
CQ
CQ
CQ
CQ
CQ
CQ
CQ
CQ
CQ
CQ
CQ
CQ
CQ
CQ
CQ
CQ
CQ
CQ
CQ
CQ
CQ
CQ
CQ
CQ
CQ
CQ
CQ
CQ
CQ
CQ
CQ
CQ
CQ
CQ
CQ
CQ
CQ
CQ
CQ
CQ
CQ
CQ
CQ
CQ
CQ
CQ
CQ
CQ
CQ
"}
(50,1,1) = {"
CQ
CQ
CQ
CQ
CQ
CQ
CQ
CQ
CQ
CQ
CQ
CQ
CQ
CQ
CQ
CQ
CQ
CQ
CQ
CQ
CQ
CQ
CQ
CQ
CQ
CQ
CQ
CQ
CQ
CQ
CQ
CQ
CQ
CQ
CQ
CQ
CQ
CQ
CQ
CQ
CQ
CQ
CQ
CQ
CQ
CQ
CQ
CQ
CQ
CQ
"}
