//MAP CONVERTED BY dmm2tgm.py THIS HEADER COMMENT PREVENTS RECONVERSION, DO NOT REMOVE
"aI" = (
/obj/machinery/door/airlock/pyro/security{
	dir = 4;
	name = "Secure Transport";
	opacity = 0
	},
/obj/access_spawn/security,
/turf/floor/shuttle_noprotections{
	icon_state = "floor4"
	},
/area/shuttle/escape/centcom/donut2)
"bz" = (
/obj/machinery/light/small/floor,
/turf/floor/shuttle_noprotections{
	icon_state = "floor2"
	},
/area/shuttle/escape/centcom/donut2)
"bW" = (
/obj/machinery/shuttle/engine/heater{
	dir = 4;
	icon_state = "alt_heater-L"
	},
/turf/floor/shuttle_noprotections{
	icon_state = "plating"
	},
/area/shuttle/escape/centcom/donut2)
"cr" = (
/obj/item/storage/wall/emergency{
	pixel_y = 4
	},
/turf/wall/r_wall/shuttle_noprotections{
	icon_state = "wall5"
	},
/area/shuttle/escape/centcom/donut2)
"ed" = (
/turf/shuttle/wall/cockpit{
	dir = 4;
	icon_state = "shuttlecock_blu"
	},
/area/shuttle/escape/centcom/donut2)
"fM" = (
/obj/item/storage/wall/fire,
/turf/wall/r_wall/shuttle_noprotections{
	icon_state = "wall5"
	},
/area/shuttle/escape/centcom/donut2)
"gm" = (
/obj/table/reinforced/auto,
/obj/item/storage/firstaid/regular,
/obj/item/storage/firstaid/regular,
/turf/floor/shuttle_noprotections{
	icon_state = "floor2"
	},
/area/shuttle/escape/centcom/donut2)
"jA" = (
/obj/machinery/shuttle/engine/heater{
	dir = 4;
	icon_state = "alt_heater-M"
	},
/turf/floor/shuttle_noprotections{
	icon_state = "plating"
	},
/area/shuttle/escape/centcom/donut2)
"lk" = (
/obj/table/auto,
/obj/random_item_spawner/med_kit,
/turf/floor/shuttle_noprotections{
	icon_state = "floor3"
	},
/area/shuttle/escape/centcom/donut2)
"ou" = (
/obj/stool/chair/comfy/shuttle{
	dir = 8
	},
/obj/machinery/light{
	dir = 1;
	pixel_y = null
	},
/turf/floor/shuttle_noprotections{
	icon_state = "floor2"
	},
/area/shuttle/escape/centcom/donut2)
"oL" = (
/obj/indestructible/shuttle_corner{
	dir = 4;
	icon = 'icons/turf/shuttle.dmi';
	icon_state = "wall5_trans"
	},
/turf/space,
/area/shuttle/escape/centcom/donut2)
"oU" = (
/obj/wingrille_spawn/reinforced,
/obj/machinery/shuttle/engine/heater{
	dir = 4;
	icon_state = "alt_heater-L"
	},
/turf/floor/shuttle_noprotections{
	icon_state = "plating"
	},
/area/shuttle/escape/centcom/donut2)
"ri" = (
/obj/wingrille_spawn/reinforced,
/obj/machinery/shuttle/engine/heater{
	dir = 4;
	icon_state = "alt_heater-M"
	},
/turf/floor/shuttle_noprotections{
	icon_state = "plating"
	},
/area/shuttle/escape/centcom/donut2)
"rU" = (
/obj/stool/chair/comfy/shuttle{
	dir = 8
	},
/obj/machinery/light,
/turf/floor/shuttle_noprotections{
	icon_state = "floor2"
	},
/area/shuttle/escape/centcom/donut2)
"tG" = (
/obj/machinery/door/airlock/pyro/medical{
	dir = 4;
	name = "First-Aid Station";
	opacity = 0
	},
/turf/floor/shuttle_noprotections{
	icon_state = "floor3"
	},
/area/shuttle/escape/centcom/donut2)
"uB" = (
/obj/stool/chair/comfy/shuttle{
	dir = 8
	},
/obj/machinery/light/small{
	dir = 8
	},
/turf/floor/shuttle_noprotections{
	icon_state = "floor2"
	},
/area/shuttle/escape/centcom/donut2)
"xR" = (
/obj/wingrille_spawn/reinforced,
/obj/machinery/shuttle/engine/heater{
	dir = 4;
	icon_state = "alt_heater-R"
	},
/turf/floor/shuttle_noprotections{
	icon_state = "plating"
	},
/area/shuttle/escape/centcom/donut2)
"xS" = (
/obj/machinery/door/airlock/pyro/external/shuttle_connect,
/turf/floor/shuttle_noprotections{
	icon_state = "floor2"
	},
/area/shuttle/escape/centcom/donut2)
"Ck" = (
/obj/item/storage/wall/medical{
	pixel_z = -1
	},
/turf/wall/r_wall/shuttle_noprotections{
	icon_state = "wall5"
	},
/area/shuttle/escape/centcom/donut2)
"CD" = (
/turf/wall/r_wall/shuttle_noprotections{
	dir = 4;
	icon_state = "wall5_floor2"
	},
/area/shuttle/escape/centcom/donut2)
"DA" = (
/obj/stool/chair/comfy/shuttle/red{
	dir = 8
	},
/turf/floor/shuttle_noprotections{
	icon_state = "floor4"
	},
/area/shuttle/escape/centcom/donut2)
"DO" = (
/obj/table/reinforced/auto,
/obj/item/storage/toolbox/emergency,
/obj/item/device/radio,
/turf/floor/shuttle_noprotections{
	icon_state = "floor2"
	},
/area/shuttle/escape/centcom/donut2)
"Gc" = (
/turf/wall/r_wall/shuttle_noprotections,
/area/shuttle/escape/centcom/donut2)
"Gd" = (
/obj/indestructible/invisible_block,
/turf/space,
/area/shuttle/escape/centcom/donut2)
"HA" = (
/obj/machinery/sleeper/compact,
/turf/floor/shuttle_noprotections{
	icon_state = "floor3"
	},
/area/shuttle/escape/centcom/donut2)
"HV" = (
/obj/machinery/shuttle/engine/propulsion{
	dir = 4;
	icon_state = "alt_propulsion"
	},
/turf/space,
/area/shuttle/escape/centcom/donut2)
"HZ" = (
/turf/wall/r_wall/shuttle_noprotections{
	dir = 1;
	icon_state = "wall5_floor2"
	},
/area/shuttle/escape/centcom/donut2)
"If" = (
/turf/space,
/area/shuttle/escape/centcom/donut2)
"Io" = (
/turf/wall/auto,
/area/centcom/outpost/docks)
"JS" = (
/obj/machinery/computer/shuttle/embedded/west,
/obj/stool/chair/comfy/shuttle/pilot{
	dir = 8
	},
/turf/floor/shuttle_noprotections{
	icon_state = "floor2"
	},
/area/shuttle/escape/centcom/donut2)
"La" = (
/obj/machinery/door/airlock/pyro/glass/command{
	dir = 4
	},
/obj/access_spawn/heads,
/turf/floor/shuttle_noprotections{
	icon_state = "floor2"
	},
/area/shuttle/escape/centcom/donut2)
"LM" = (
/obj/indestructible/shuttle_corner{
	icon = 'icons/turf/shuttle.dmi';
	icon_state = "wall5_trans"
	},
/turf/space,
/area/shuttle/escape/centcom/donut2)
"Ns" = (
/obj/stool/chair/comfy/shuttle{
	dir = 8
	},
/obj/machinery/light/small/floor,
/turf/floor/shuttle_noprotections{
	icon_state = "floor2"
	},
/area/shuttle/escape/centcom/donut2)
"NM" = (
/obj/indestructible/shuttle_corner{
	dir = 8;
	icon = 'icons/turf/shuttle.dmi';
	icon_state = "wall5_trans"
	},
/turf/space,
/area/shuttle/escape/centcom/donut2)
"Od" = (
/turf/space,
/area/space)
"OL" = (
/obj/stool/chair/comfy/shuttle/green{
	dir = 8
	},
/turf/floor/shuttle_noprotections{
	icon_state = "floor3"
	},
/area/shuttle/escape/centcom/donut2)
"PK" = (
/obj/machinery/light/small/floor,
/turf/floor/shuttle_noprotections{
	icon_state = "floor3"
	},
/area/shuttle/escape/centcom/donut2)
"TD" = (
/obj/stool/chair/comfy/shuttle{
	dir = 8
	},
/turf/floor/shuttle_noprotections{
	icon_state = "floor2"
	},
/area/shuttle/escape/centcom/donut2)
"Vz" = (
/obj/wingrille_spawn/reinforced,
/turf/floor/shuttle_noprotections{
	icon_state = "plating"
	},
/area/shuttle/escape/centcom/donut2)
"VV" = (
/turf/floor/shuttle_noprotections{
	icon_state = "floor2"
	},
/area/shuttle/escape/centcom/donut2)
"Wb" = (
/obj/machinery/light/small/floor,
/turf/floor/shuttle_noprotections{
	icon_state = "floor4"
	},
/area/shuttle/escape/centcom/donut2)
"Wf" = (
/obj/indestructible/shuttle_corner{
	dir = 1;
	icon = 'icons/turf/shuttle.dmi';
	icon_state = "wall5_trans"
	},
/turf/space,
/area/shuttle/escape/centcom/donut2)
"WE" = (
/obj/stool/chair/comfy/shuttle/brown{
	dir = 8
	},
/turf/floor/shuttle_noprotections{
	icon_state = "floor2"
	},
/area/shuttle/escape/centcom/donut2)
"Xk" = (
/turf/wall/r_wall/shuttle_noprotections{
	icon_state = "wall5"
	},
/area/shuttle/escape/centcom/donut2)
"XU" = (
/obj/machinery/shuttle/engine/heater{
	dir = 4;
	icon_state = "alt_heater-R"
	},
/turf/floor/shuttle_noprotections{
	icon_state = "plating"
	},
/area/shuttle/escape/centcom/donut2)
"Yz" = (
/turf/floor/stairs{
	dir = 1
	},
/area/centcom/outpost/docks)
"YA" = (
/turf/floor/stairs,
/area/centcom/outpost/docks)

(1,1,1) = {"
Od
Od
Od
Od
Gd
ed
Gd
Od
Od
Od
Od
"}
(2,1,1) = {"
Od
Od
Od
NM
Gc
Gc
Gc
LM
Od
Od
Od
"}
(3,1,1) = {"
Od
Od
NM
CD
WE
JS
WE
HZ
LM
Od
Od
"}
(4,1,1) = {"
Od
Od
Xk
DO
WE
bz
WE
gm
Xk
Od
Od
"}
(5,1,1) = {"
Od
NM
Xk
Vz
Xk
La
Xk
Vz
Xk
LM
Od
"}
(6,1,1) = {"
Od
Xk
CD
TD
uB
VV
uB
TD
HZ
Xk
Od
"}
(7,1,1) = {"
Io
Xk
TD
Ns
TD
VV
TD
Ns
TD
Xk
Io
"}
(8,1,1) = {"
YA
xS
VV
VV
VV
VV
VV
VV
VV
xS
Yz
"}
(9,1,1) = {"
Io
cr
TD
VV
TD
TD
TD
VV
TD
Xk
Io
"}
(10,1,1) = {"
Od
Vz
TD
VV
TD
Ns
TD
VV
TD
Vz
Od
"}
(11,1,1) = {"
Od
Vz
TD
VV
TD
TD
TD
VV
TD
Vz
Od
"}
(12,1,1) = {"
Io
fM
ou
VV
VV
Vz
VV
VV
rU
Xk
Io
"}
(13,1,1) = {"
YA
xS
VV
VV
TD
TD
TD
VV
VV
xS
Yz
"}
(14,1,1) = {"
Io
Xk
TD
VV
TD
TD
TD
VV
TD
Xk
Io
"}
(15,1,1) = {"
NM
Xk
Xk
tG
Xk
Xk
Xk
aI
Xk
Xk
LM
"}
(16,1,1) = {"
Xk
Ck
OL
PK
OL
Xk
DA
Wb
DA
Xk
Xk
"}
(17,1,1) = {"
HV
Xk
HA
lk
HA
Xk
DA
DA
DA
Xk
HV
"}
(18,1,1) = {"
Od
Wf
xR
ri
oU
Xk
XU
jA
bW
oL
Od
"}
(19,1,1) = {"
Od
If
HV
HV
HV
If
HV
HV
HV
If
Od
"}
