//MAP CONVERTED BY dmm2tgm.py THIS HEADER COMMENT PREVENTS RECONVERSION, DO NOT REMOVE
"aI" = (
/obj/machinery/door/airlock/pyro/security{
	dir = 4;
	name = "Secure Transport";
	opacity = 0
	},
/turf/floor/shuttle{
	dir = 8
	},
/area/shuttle/escape/centcom/donut2)
"bz" = (
/obj/machinery/light/small/floor,
/turf/floor/shuttle{
	dir = 8;
	icon_state = "floor2"
	},
/area/shuttle/escape/centcom/donut2)
"bW" = (
/obj/machinery/shuttle/engine/heater{
	dir = 4;
	icon_state = "alt_heater-L"
	},
/turf/floor/plating,
/area/shuttle/escape/centcom/donut2)
"cr" = (
/obj/item/storage/wall/emergency{
	pixel_y = 4
	},
/turf/wall/auto/shuttle{
	icon_state = "13"
	},
/area/shuttle/escape/centcom/donut2)
"dh" = (
/turf/wall/auto/shuttle{
	icon_state = "15"
	},
/area/shuttle/escape/centcom/donut2)
"ed" = (
/turf/shuttle/wall/cockpit{
	dir = 4;
	layer = 50
	},
/area/shuttle/escape/centcom/donut2)
"fM" = (
/obj/item/storage/wall/fire,
/turf/wall/auto/shuttle{
	icon_state = "13"
	},
/area/shuttle/escape/centcom/donut2)
"gm" = (
/obj/table/reinforced/auto,
/obj/item/storage/firstaid/regular,
/obj/item/storage/firstaid/regular,
/turf/floor/shuttle{
	dir = 8;
	icon_state = "floor2"
	},
/area/shuttle/escape/centcom/donut2)
"gI" = (
/turf/wall{
	dir = 1;
	icon = 'icons/misc/worlds.dmi';
	icon_state = "leadcap"
	},
/area/centcom)
"iw" = (
/obj/indestructible/shuttle_corner{
	dir = 8
	},
/turf/floor/shuttle{
	dir = 8;
	icon_state = "floor2"
	},
/area/shuttle/escape/centcom/donut2)
"jA" = (
/obj/machinery/shuttle/engine/heater{
	dir = 4;
	icon_state = "alt_heater-M"
	},
/turf/floor/plating,
/area/shuttle/escape/centcom/donut2)
"lk" = (
/obj/table/auto,
/obj/random_item_spawner/med_kit,
/turf/floor/shuttle{
	dir = 8;
	icon_state = "floor3"
	},
/area/shuttle/escape/centcom/donut2)
"ou" = (
/obj/stool/chair/comfy/shuttle{
	dir = 8
	},
/obj/machinery/light{
	dir = 1;
	pixel_y = 21
	},
/turf/floor/shuttle{
	dir = 8
	},
/area/shuttle/escape/centcom/donut2)
"oL" = (
/obj/indestructible/shuttle_corner{
	dir = 8
	},
/turf/outdoors/grass,
/area/shuttle/escape/centcom/donut2)
"oU" = (
/obj/wingrille_spawn/auto,
/obj/machinery/shuttle/engine/heater{
	dir = 4;
	icon_state = "alt_heater-L"
	},
/turf/floor/plating,
/area/shuttle/escape/centcom/donut2)
"ri" = (
/obj/wingrille_spawn/auto,
/obj/machinery/shuttle/engine/heater{
	dir = 4;
	icon_state = "alt_heater-M"
	},
/turf/floor/plating,
/area/shuttle/escape/centcom/donut2)
"rU" = (
/obj/stool/chair/comfy/shuttle{
	dir = 8
	},
/obj/machinery/light,
/turf/floor/shuttle{
	dir = 8
	},
/area/shuttle/escape/centcom/donut2)
"tG" = (
/obj/machinery/door/airlock/pyro/medical{
	dir = 4;
	name = "First-Aid Station";
	opacity = 0
	},
/turf/floor/shuttle{
	dir = 8
	},
/area/shuttle/escape/centcom/donut2)
"uE" = (
/obj/indestructible/shuttle_corner{
	dir = 1
	},
/turf/floor/shuttle{
	dir = 8
	},
/area/shuttle/escape/centcom/donut2)
"vY" = (
/turf/wall/auto/shuttle{
	icon_state = "12"
	},
/area/shuttle/escape/centcom/donut2)
"xR" = (
/obj/wingrille_spawn/auto,
/obj/machinery/shuttle/engine/heater{
	dir = 4;
	icon_state = "alt_heater-R"
	},
/turf/floor/plating,
/area/shuttle/escape/centcom/donut2)
"xS" = (
/obj/machinery/door/airlock/pyro/external{
	dir = 1
	},
/turf/floor/shuttle{
	dir = 8
	},
/area/shuttle/escape/centcom/donut2)
"xV" = (
/turf/wall/auto/shuttle{
	icon_state = "1"
	},
/area/shuttle/escape/centcom/donut2)
"yN" = (
/obj/wingrille_spawn/auto,
/turf/floor/shuttle{
	dir = 8
	},
/area/shuttle/escape/centcom/donut2)
"Ck" = (
/obj/item/storage/wall/medical{
	pixel_z = -1
	},
/turf/wall/auto/shuttle{
	icon_state = "12"
	},
/area/shuttle/escape/centcom/donut2)
"CD" = (
/obj/indestructible/shuttle_corner{
	dir = 8
	},
/turf/floor/shuttle{
	dir = 8
	},
/area/shuttle/escape/centcom/donut2)
"DA" = (
/obj/stool/chair/comfy/shuttle/red{
	dir = 8
	},
/turf/floor/shuttle{
	dir = 8;
	icon_state = "floor4"
	},
/area/shuttle/escape/centcom/donut2)
"DO" = (
/obj/table/reinforced/auto,
/obj/item/storage/toolbox/emergency,
/obj/item/device/radio,
/turf/floor/shuttle{
	dir = 8;
	icon_state = "floor2"
	},
/area/shuttle/escape/centcom/donut2)
"Em" = (
/turf/wall/auto/shuttle{
	icon_state = "3"
	},
/area/shuttle/escape/centcom/donut2)
"FS" = (
/turf/wall/auto/shuttle{
	icon_state = "7"
	},
/area/shuttle/escape/centcom/donut2)
"Gb" = (
/turf/wall/auto/shuttle{
	icon_state = "8"
	},
/area/shuttle/escape/centcom/donut2)
"Gd" = (
/obj/indestructible/invisible_block,
/turf/outdoors/grass,
/area/shuttle/escape/centcom/donut2)
"HA" = (
/obj/machinery/sleeper/compact,
/turf/floor/shuttle{
	dir = 8;
	icon_state = "floor3"
	},
/area/shuttle/escape/centcom/donut2)
"HV" = (
/obj/machinery/shuttle/engine/propulsion{
	dir = 4;
	icon_state = "alt_propulsion"
	},
/turf/outdoors/grass,
/area/shuttle/escape/centcom/donut2)
"HZ" = (
/obj/indestructible/shuttle_corner{
	dir = 1
	},
/turf/floor/shuttle{
	dir = 8;
	icon_state = "floor2"
	},
/area/shuttle/escape/centcom/donut2)
"If" = (
/turf/outdoors/grass,
/area/shuttle/escape/centcom/donut2)
"Io" = (
/turf/wall{
	icon = 'icons/misc/worlds.dmi';
	icon_state = "leadcap"
	},
/area/centcom)
"JS" = (
/obj/machinery/computer/shuttle/embedded/west,
/obj/stool/chair/comfy/shuttle/pilot{
	dir = 8
	},
/turf/floor/shuttle{
	dir = 8;
	icon_state = "floor2"
	},
/area/shuttle/escape/centcom/donut2)
"La" = (
/obj/machinery/door/airlock/pyro/command{
	dir = 4;
	opacity = 0
	},
/turf/floor/shuttle{
	dir = 8;
	icon_state = "floor2"
	},
/area/shuttle/escape/centcom/donut2)
"LM" = (
/obj/indestructible/shuttle_corner{
	dir = 4
	},
/turf/outdoors/grass,
/area/shuttle/escape/centcom/donut2)
"Ns" = (
/obj/stool/chair/comfy/shuttle{
	dir = 8
	},
/obj/machinery/light/small/floor,
/turf/floor/shuttle{
	dir = 8
	},
/area/shuttle/escape/centcom/donut2)
"NM" = (
/obj/indestructible/shuttle_corner,
/turf/outdoors/grass,
/area/shuttle/escape/centcom/donut2)
"Od" = (
/turf/outdoors/grass,
/area/centcom/outside)
"OL" = (
/obj/stool/chair/comfy/shuttle/green{
	dir = 8
	},
/turf/floor/shuttle{
	dir = 8;
	icon_state = "floor3"
	},
/area/shuttle/escape/centcom/donut2)
"Pz" = (
/turf/wall/auto/shuttle{
	icon_state = "14"
	},
/area/shuttle/escape/centcom/donut2)
"PK" = (
/obj/machinery/light/small/floor,
/turf/floor/shuttle{
	dir = 8;
	icon_state = "floor3"
	},
/area/shuttle/escape/centcom/donut2)
"QK" = (
/turf/wall/auto/shuttle{
	icon_state = "2"
	},
/area/shuttle/escape/centcom/donut2)
"TD" = (
/obj/stool/chair/comfy/shuttle{
	dir = 8
	},
/turf/floor/shuttle{
	dir = 8
	},
/area/shuttle/escape/centcom/donut2)
"Vz" = (
/obj/wingrille_spawn/auto,
/turf/floor/shuttle{
	dir = 8;
	icon_state = "floor2"
	},
/area/shuttle/escape/centcom/donut2)
"VV" = (
/turf/floor/shuttle{
	dir = 8
	},
/area/shuttle/escape/centcom/donut2)
"Wb" = (
/obj/machinery/light/small/floor,
/turf/floor/shuttle{
	dir = 8;
	icon_state = "floor4"
	},
/area/shuttle/escape/centcom/donut2)
"Wf" = (
/obj/indestructible/shuttle_corner{
	dir = 1
	},
/turf/outdoors/grass,
/area/shuttle/escape/centcom/donut2)
"WE" = (
/obj/stool/chair/comfy/shuttle/brown{
	dir = 8
	},
/turf/floor/shuttle{
	dir = 8;
	icon_state = "floor2"
	},
/area/shuttle/escape/centcom/donut2)
"Xk" = (
/turf/wall/auto/shuttle{
	icon_state = "13"
	},
/area/shuttle/escape/centcom/donut2)
"XU" = (
/obj/machinery/shuttle/engine/heater{
	dir = 4;
	icon_state = "alt_heater-R"
	},
/turf/floor/plating,
/area/shuttle/escape/centcom/donut2)
"Yz" = (
/turf/floor/stairs{
	dir = 1
	},
/area/centcom)
"YA" = (
/turf/floor/stairs,
/area/centcom)

(1,1,1) = {"
Od
Od
Od
Od
Gd
ed
Gd
Od
Od
Od
Od
"}
(2,1,1) = {"
Od
Od
Od
NM
Em
Em
Em
LM
Od
Od
Od
"}
(3,1,1) = {"
Od
Od
NM
iw
WE
JS
WE
HZ
LM
Od
Od
"}
(4,1,1) = {"
Od
Od
vY
DO
WE
bz
WE
gm
vY
Od
Od
"}
(5,1,1) = {"
Od
NM
dh
Vz
Em
La
Em
Vz
dh
LM
Od
"}
(6,1,1) = {"
Od
Pz
CD
TD
TD
VV
TD
TD
uE
Xk
Od
"}
(7,1,1) = {"
Io
Xk
TD
Ns
TD
VV
TD
Ns
TD
Pz
gI
"}
(8,1,1) = {"
YA
xS
VV
VV
VV
VV
VV
VV
VV
xS
Yz
"}
(9,1,1) = {"
Io
cr
TD
VV
TD
TD
TD
VV
TD
Pz
gI
"}
(10,1,1) = {"
Od
yN
TD
VV
TD
Ns
TD
VV
TD
yN
Od
"}
(11,1,1) = {"
Od
yN
TD
VV
TD
TD
TD
VV
TD
yN
Od
"}
(12,1,1) = {"
Io
fM
ou
VV
QK
yN
xV
VV
rU
Pz
gI
"}
(13,1,1) = {"
YA
xS
VV
VV
TD
TD
TD
VV
VV
xS
Yz
"}
(14,1,1) = {"
Io
Xk
TD
VV
TD
TD
TD
VV
TD
Pz
gI
"}
(15,1,1) = {"
NM
dh
Em
tG
Em
FS
Em
aI
Em
dh
LM
"}
(16,1,1) = {"
Gb
Ck
OL
PK
OL
vY
DA
Wb
DA
vY
Gb
"}
(17,1,1) = {"
HV
vY
HA
lk
HA
vY
DA
DA
DA
vY
HV
"}
(18,1,1) = {"
Od
Wf
xR
ri
oU
Gb
XU
jA
bW
oL
Od
"}
(19,1,1) = {"
Od
If
HV
HV
HV
If
HV
HV
HV
If
Od
"}
