"a" = (/turf/dmm_suite/clear_turf,/area/dmm_suite/clear_area)
"h" = (/obj/storage/crate/trench_loot/ship3,/turf/dmm_suite/clear_turf,/area/dmm_suite/clear_area)
"p" = (/obj/storage/crate/packing,/obj/random_item_spawner/med_kit/few,/turf/dmm_suite/clear_turf,/area/dmm_suite/clear_area)
"B" = (/obj/storage/crate/trench_loot/ore3,/turf/dmm_suite/clear_turf,/area/dmm_suite/clear_area)
"D" = (/obj/storage/crate/trench_loot/weapons3,/turf/dmm_suite/clear_turf,/area/dmm_suite/clear_area)
"S" = (/obj/storage/crate/packing,/obj/random_item_spawner/prosthetics,/obj/random_item_spawner/organs/one_to_three,/turf/dmm_suite/clear_turf,/area/dmm_suite/clear_area)

(1,1,1) = {"
BSaaa
aaaaa
pDhaa
"}
