"a" = (/turf/dmm_suite/clear_turf,/area/dmm_suite/clear_area)
"p" = (/obj/storage/crate/packing,/obj/random_item_spawner/med_kit/one,/obj/random_item_spawner/med_kit/one_or_zero,/turf/dmm_suite/clear_turf,/area/dmm_suite/clear_area)
"D" = (/obj/storage/crate/packing,/obj/random_item_spawner/medicine/two,/turf/dmm_suite/clear_turf,/area/dmm_suite/clear_area)
"S" = (/obj/storage/crate/packing,/obj/random_item_spawner/prosthetics,/obj/random_item_spawner/organs/one_to_three,/turf/dmm_suite/clear_turf,/area/dmm_suite/clear_area)

(1,1,1) = {"
aSaaa
aaaaa
paaDa
"}
