"a" = (/obj/machinery/light/incandescent/netural{dir = 8},/turf/simulated/floor/specialroom/cafeteria,/area/dmm_suite/clear_area)
"b" = (/obj/stool/chair/yellow{dir = 4},/turf/simulated/floor/specialroom/cafeteria,/area/dmm_suite/clear_area)
"c" = (/obj/stool/chair/yellow{dir = 8},/obj/decal/cleanable/dirt/dirt2,/turf/simulated/floor/specialroom/cafeteria,/area/dmm_suite/clear_area)
"d" = (/obj/machinery/light/incandescent/netural{dir = 8},/obj/machinery/vending/cola/red{pixel_y = 12},/turf/simulated/floor/specialroom/cafeteria,/area/dmm_suite/clear_area)
"e" = (/obj/stool/chair/yellow{dir = 4},/obj/machinery/light/incandescent/netural{dir = 8},/turf/simulated/floor/specialroom/cafeteria,/area/dmm_suite/clear_area)
"i" = (/obj/decal/poster{pixel_y = 28},/obj/machinery/light/incandescent/netural{dir = 4},/turf/simulated/floor/specialroom/cafeteria,/area/dmm_suite/clear_area)
"k" = (/obj/decal/cleanable/dirt,/turf/simulated/floor/orange,/area/dmm_suite/clear_area)
"l" = (/obj/stool/chair/yellow{dir = 4},/obj/decal/cleanable/ketchup,/turf/simulated/floor/specialroom/cafeteria,/area/dmm_suite/clear_area)
"p" = (/turf/simulated/floor/specialroom/cafeteria,/area/dmm_suite/clear_area)
"r" = (/obj/stool/chair/yellow{dir = 4},/obj/decal/cleanable/dirt/dirt3,/turf/simulated/floor/specialroom/cafeteria,/area/dmm_suite/clear_area)
"s" = (/obj/stool/chair/yellow{dir = 8},/turf/simulated/floor/specialroom/cafeteria,/area/dmm_suite/clear_area)
"t" = (/obj/machinery/vending/pizza{pixel_y = 16},/turf/simulated/floor/specialroom/cafeteria,/area/dmm_suite/clear_area)
"u" = (/obj/machinery/light/incandescent/netural{dir = 4},/obj/machinery/power/apc/autoname_east,/turf/simulated/floor/specialroom/cafeteria,/area/dmm_suite/clear_area)
"w" = (/obj/decal/cleanable/dirt/dirt5,/obj/decal/cleanable/dirt/dirt2,/turf/simulated/floor/specialroom/cafeteria,/area/dmm_suite/clear_area)
"x" = (/obj/decal/cleanable/dirt/dirt3,/turf/simulated/floor/specialroom/cafeteria,/area/dmm_suite/clear_area)
"y" = (/obj/table/reinforced/auto,/obj/item/platestack,/turf/simulated/floor/specialroom/cafeteria,/area/dmm_suite/clear_area)
"C" = (/obj/machinery/light/incandescent/netural{dir = 1},/turf/simulated/floor/specialroom/cafeteria,/area/dmm_suite/clear_area)
"D" = (/obj/decal/cleanable/dirt/dirt4,/obj/machinery/light/incandescent/netural{dir = 4},/turf/simulated/floor/specialroom/cafeteria,/area/dmm_suite/clear_area)
"E" = (/obj/table/reinforced/auto,/turf/simulated/floor/specialroom/cafeteria,/area/dmm_suite/clear_area)
"F" = (/obj/decal/cleanable/dirt/dirt2,/turf/simulated/floor/specialroom/cafeteria,/area/dmm_suite/clear_area)
"G" = (/obj/decal/cleanable/eggsplat,/turf/simulated/floor/specialroom/cafeteria,/area/dmm_suite/clear_area)
"H" = (/obj/table/reinforced/auto,/obj/item/shaker/ketchup,/turf/simulated/floor/specialroom/cafeteria,/area/dmm_suite/clear_area)
"I" = (/obj/stool/chair/yellow{dir = 8},/obj/machinery/light/incandescent/netural{dir = 4},/turf/simulated/floor/specialroom/cafeteria,/area/dmm_suite/clear_area)
"K" = (/obj/table/round,/turf/simulated/floor/specialroom/cafeteria,/area/dmm_suite/clear_area)
"M" = (/obj/decal/cleanable/dirt/dirt5,/turf/simulated/floor/specialroom/cafeteria,/area/dmm_suite/clear_area)
"T" = (/turf/simulated/floor/orange,/area/dmm_suite/clear_area)
"V" = (/obj/table/round,/obj/item/shaker/mustard,/turf/simulated/floor/specialroom/cafeteria,/area/dmm_suite/clear_area)
"W" = (/obj/stool/chair/yellow{dir = 4},/obj/decal/cleanable/paper,/turf/simulated/floor/specialroom/cafeteria,/area/dmm_suite/clear_area)
"Y" = (/obj/table/round,/obj/item/shaker/ketchup,/turf/simulated/floor/specialroom/cafeteria,/area/dmm_suite/clear_area)
"Z" = (/obj/decal/cleanable/dirt/jen,/turf/simulated/floor/specialroom/cafeteria,/area/dmm_suite/clear_area)

(1,1,1) = {"
CpGppppEti
MwMMMwpppp
EEyEEEHEpx
dpppppppxD
bKKcppWVKs
lYKsppbKKs
eKKsppbKYI
bVKspprKKs
pFppZppppp
apppTkpppu
"}
