"a" = (/turf/simulated/floor/specialroom/cafeteria,/area/dmm_suite/clear_area)
"b" = (/obj/stool/chair/yellow{dir = 4},/obj/decal/cleanable/ketchup,/turf/simulated/floor/specialroom/cafeteria,/area/dmm_suite/clear_area)
"c" = (/obj/decal/poster/wallsign/foodhole/nanoburg{pixel_y = 24},/turf/simulated/floor/specialroom/cafeteria,/area/dmm_suite/clear_area)
"f" = (/obj/table/reinforced/auto,/obj/item/reagent_containers/food/drinks/drinkingglass/random_style,/turf/simulated/floor/specialroom/cafeteria,/area/dmm_suite/clear_area)
"g" = (/obj/machinery/power/apc/autoname_east,/turf/simulated/floor/specialroom/cafeteria,/area/dmm_suite/clear_area)
"h" = (/obj/decal/cleanable/dirt/dirt5,/turf/simulated/floor/specialroom/cafeteria,/area/dmm_suite/clear_area)
"i" = (/obj/table/round,/obj/item/shaker/ketchup,/turf/simulated/floor/specialroom/cafeteria,/area/dmm_suite/clear_area)
"j" = (/obj/machinery/vending/cola/red{pixel_y = 12},/turf/simulated/floor/specialroom/cafeteria,/area/dmm_suite/clear_area)
"k" = (/obj/stool/chair/yellow{dir = 4},/obj/decal/cleanable/dirt/dirt3,/turf/simulated/floor/specialroom/cafeteria,/area/dmm_suite/clear_area)
"l" = (/obj/stool/chair/yellow{dir = 8},/obj/item/crushed_can,/turf/simulated/floor/specialroom/cafeteria,/area/dmm_suite/clear_area)
"m" = (/obj/machinery/vending/pizza,/turf/simulated/floor/specialroom/cafeteria,/area/dmm_suite/clear_area)
"o" = (/obj/table/reinforced/auto,/obj/machinery/light/small/ceiling/harsh,/turf/simulated/floor/specialroom/cafeteria,/area/dmm_suite/clear_area)
"q" = (/obj/table/round,/obj/item/reagent_containers/food/drinks/cola/random,/turf/simulated/floor/specialroom/cafeteria,/area/dmm_suite/clear_area)
"s" = (/obj/stool/chair/yellow{dir = 4},/turf/simulated/floor/specialroom/cafeteria,/area/dmm_suite/clear_area)
"u" = (/obj/decal/cleanable/dirt/dirt2,/turf/simulated/floor/specialroom/cafeteria,/area/dmm_suite/clear_area)
"v" = (/obj/machinery/light/small/neutral{dir = 1},/turf/simulated/floor/specialroom/cafeteria,/area/dmm_suite/clear_area)
"w" = (/obj/decal/poster{pixel_y = 28},/obj/machinery/light/small/neutral{dir = 1},/turf/simulated/floor/specialroom/cafeteria,/area/dmm_suite/clear_area)
"x" = (/obj/stool/chair/yellow{dir = 8},/turf/simulated/floor/specialroom/cafeteria,/area/dmm_suite/clear_area)
"z" = (/obj/table/reinforced/auto,/obj/item/shaker/ketchup,/obj/machinery/light/small/ceiling/harsh,/turf/simulated/floor/specialroom/cafeteria,/area/dmm_suite/clear_area)
"B" = (/obj/stool/chair/yellow{dir = 4},/obj/machinery/light/small/ceiling/harsh,/turf/simulated/floor/specialroom/cafeteria,/area/dmm_suite/clear_area)
"C" = (/obj/table/reinforced/auto,/turf/simulated/floor/specialroom/cafeteria,/area/dmm_suite/clear_area)
"E" = (/obj/stool/chair/yellow{dir = 8},/obj/machinery/light/small/ceiling/harsh,/turf/simulated/floor/specialroom/cafeteria,/area/dmm_suite/clear_area)
"F" = (/obj/stool/chair/yellow{dir = 4},/obj/decal/cleanable/paper,/obj/machinery/light/small/ceiling/harsh,/turf/simulated/floor/specialroom/cafeteria,/area/dmm_suite/clear_area)
"G" = (/obj/machinery/light/small/ceiling/harsh,/turf/simulated/floor/specialroom/cafeteria,/area/dmm_suite/clear_area)
"H" = (/obj/decal/cleanable/dirt/jen,/turf/simulated/floor/specialroom/cafeteria,/area/dmm_suite/clear_area)
"J" = (/obj/decal/cleanable/dirt/jen,/turf/simulated/floor/orange,/area/dmm_suite/clear_area)
"K" = (/obj/table/reinforced/auto,/obj/item/platestack,/turf/simulated/floor/specialroom/cafeteria,/area/dmm_suite/clear_area)
"N" = (/obj/decal/cleanable/dirt/dirt3,/obj/machinery/light/small/ceiling/harsh,/turf/simulated/floor/specialroom/cafeteria,/area/dmm_suite/clear_area)
"O" = (/obj/table/round,/turf/simulated/floor/specialroom/cafeteria,/area/dmm_suite/clear_area)
"S" = (/obj/table/round,/obj/item/shaker/mustard,/turf/simulated/floor/specialroom/cafeteria,/area/dmm_suite/clear_area)
"U" = (/obj/decal/cleanable/dirt,/turf/simulated/floor/orange,/area/dmm_suite/clear_area)
"X" = (/obj/machinery/food_display/nanoburg{pixel_y = 24},/turf/simulated/floor/specialroom/cafeteria,/area/dmm_suite/clear_area)
"Y" = (/obj/decal/cleanable/eggsplat,/obj/machinery/food_display/nanoburg{pixel_y = 24},/turf/simulated/floor/specialroom/cafeteria,/area/dmm_suite/clear_area)

(1,1,1) = {"
vaYacaXCmw
aahaaaaaaa
oCKofCzCaN
jaaaaaaaaa
BOOEaaFSOE
biOxHasOqx
BOOEaaBOiE
sSOxaakOOl
GuaGHHGHaG
aaaaJUaaag
"}
