"a" = (/turf/simulated/floor/specialroom/clown,/area/dmm_suite/clear_area)
"b" = (/obj/decal/cleanable/dirt/dirt2,/obj/decal/cleanable/dirt/jen,/turf/simulated/floor/specialroom/clown,/area/dmm_suite/clear_area)
"d" = (/turf/simulated/floor/grime,/area/dmm_suite/clear_area)
"e" = (/obj/table/round,/turf/simulated/floor/specialroom/clown,/area/dmm_suite/clear_area)
"g" = (/obj/table/round,/obj/decal/cleanable/fungus,/turf/simulated/floor/specialroom/clown,/area/dmm_suite/clear_area)
"h" = (/obj/stool/bench/blue,/turf/simulated/floor/specialroom/clown,/area/dmm_suite/clear_area)
"i" = (/obj/machinery/food_display/notaburger{pixel_y = 24},/obj/storage/cart/hotdog,/turf/simulated/floor/grime,/area/dmm_suite/clear_area)
"j" = (/obj/stool/bench/yellow,/obj/machinery/light/small/ceiling/purpleish,/turf/simulated/floor/specialroom/clown,/area/dmm_suite/clear_area)
"k" = (/obj/table/reinforced/auto,/obj/item/storage/box/donkpocket_kit,/obj/item/storage/box/donkpocket_kit,/turf/simulated/floor/grime,/area/dmm_suite/clear_area)
"l" = (/obj/machinery/power/apc/autoname_east,/turf/simulated/floor/specialroom/clown,/area/dmm_suite/clear_area)
"m" = (/obj/decal/cleanable/dirt/dirt3,/obj/decal/cleanable/dirt/jen,/turf/simulated/floor/specialroom/clown,/area/dmm_suite/clear_area)
"n" = (/obj/stool/bench/yellow,/turf/simulated/floor/specialroom/clown,/area/dmm_suite/clear_area)
"o" = (/obj/machinery/deep_fryer,/obj/decal/cleanable/fungus{pixel_y = 18},/obj/machinery/food_display/notaburger{pixel_y = 24},/turf/simulated/floor/grime,/area/dmm_suite/clear_area)
"p" = (/obj/stool/bench/green,/obj/machinery/light/small/ceiling/purpleish,/turf/simulated/floor/specialroom/clown,/area/dmm_suite/clear_area)
"q" = (/obj/machinery/deep_fryer,/turf/simulated/floor/grime,/area/dmm_suite/clear_area)
"r" = (/obj/table/reinforced/auto,/obj/item/shaker/ketchup,/turf/simulated/floor/specialroom/clown,/area/dmm_suite/clear_area)
"s" = (/obj/machinery/light/small/neutral{dir = 1},/turf/simulated/floor/grime,/area/dmm_suite/clear_area)
"u" = (/obj/stool/bench/red,/obj/machinery/light/small/ceiling/purpleish,/turf/simulated/floor/specialroom/clown,/area/dmm_suite/clear_area)
"v" = (/obj/decal/cleanable/water,/obj/decal/cleanable/blood/tracks{dir = 10},/turf/simulated/floor/grime,/area/dmm_suite/clear_area)
"w" = (/obj/table/round,/obj/decal/cleanable/vomit,/obj/random_item_spawner/tableware,/turf/simulated/floor/specialroom/clown,/area/dmm_suite/clear_area)
"x" = (/obj/decal/cleanable/dirt/jen,/turf/simulated/floor/specialroom/clown,/area/dmm_suite/clear_area)
"y" = (/obj/table/round,/obj/item/shaker/salt,/turf/simulated/floor/specialroom/clown,/area/dmm_suite/clear_area)
"z" = (/obj/stool/bench/red,/obj/decal/cleanable/dirt/dirt2,/obj/machinery/light/small/ceiling/purpleish,/turf/simulated/floor/specialroom/clown,/area/dmm_suite/clear_area)
"A" = (/obj/stool/bench/green,/turf/simulated/floor/specialroom/clown,/area/dmm_suite/clear_area)
"B" = (/obj/table/round,/obj/random_item_spawner/tableware,/turf/simulated/floor/specialroom/clown,/area/dmm_suite/clear_area)
"C" = (/obj/decal/cleanable/dirt/dirt4,/obj/decal/cleanable/dirt/jen,/turf/simulated/floor/specialroom/clown,/area/dmm_suite/clear_area)
"D" = (/obj/decal/cleanable/dirt/dirt2,/turf/simulated/floor/specialroom/clown,/area/dmm_suite/clear_area)
"E" = (/obj/machinery/light/small/neutral{dir = 8},/turf/simulated/floor/grime,/area/dmm_suite/clear_area)
"F" = (/obj/machinery/vending/meat,/turf/simulated/floor/grime,/area/dmm_suite/clear_area)
"G" = (/obj/table/reinforced/auto,/obj/random_item_spawner/tableware/lots,/turf/simulated/floor/specialroom/clown,/area/dmm_suite/clear_area)
"H" = (/obj/machinery/microwave,/obj/table/reinforced/auto,/turf/simulated/floor/grime,/area/dmm_suite/clear_area)
"I" = (/obj/stool/bench/blue,/obj/machinery/light/small/ceiling/purpleish,/turf/simulated/floor/specialroom/clown,/area/dmm_suite/clear_area)
"J" = (/obj/table/round,/obj/decal/cleanable/fungus,/obj/random_item_spawner/tableware,/turf/simulated/floor/specialroom/clown,/area/dmm_suite/clear_area)
"L" = (/obj/table/reinforced/auto,/turf/simulated/floor/specialroom/clown,/area/dmm_suite/clear_area)
"O" = (/obj/stool/bench/red,/obj/decal/cleanable/tomatosplat,/turf/simulated/floor/specialroom/clown,/area/dmm_suite/clear_area)
"P" = (/obj/machinery/light/small/ceiling/purpleish,/turf/simulated/floor/specialroom/clown,/area/dmm_suite/clear_area)
"R" = (/obj/decal/cleanable/blood/tracks{dir = 4},/turf/simulated/floor/grime,/area/dmm_suite/clear_area)
"S" = (/obj/decal/cleanable/blood/tracks{dir = 6},/obj/decal/cleanable/blood/splatter/extra,/turf/simulated/floor/grime,/area/dmm_suite/clear_area)
"T" = (/obj/machinery/vending/cola/blue{pixel_y = 12},/turf/simulated/floor/specialroom/clown,/area/dmm_suite/clear_area)
"U" = (/obj/machinery/light/small/neutral{dir = 4},/turf/simulated/floor/grime,/area/dmm_suite/clear_area)
"W" = (/obj/decal/poster/wallsign/foodhole/notaburger{pixel_y = 20},/obj/table/reinforced/auto,/obj/item/storage/box/donkpocket_kit,/obj/item/storage/box/donkpocket_kit,/turf/simulated/floor/grime,/area/dmm_suite/clear_area)
"X" = (/obj/table/round,/obj/item/shaker/pepper,/turf/simulated/floor/specialroom/clown,/area/dmm_suite/clear_area)
"Y" = (/obj/machinery/light/small/neutral{dir = 1},/obj/machinery/vending/kitchen,/turf/simulated/floor/grime,/area/dmm_suite/clear_area)
"Z" = (/obj/table/round,/obj/item/shaker/mustard,/turf/simulated/floor/specialroom/clown,/area/dmm_suite/clear_area)

(1,1,1) = {"
dsiHWkoqYF
dddddddvRS
EddddddddU
LLLGLrLLaa
TPaaaaaaPa
yAaIeezahJ
BuaOBenape
ghapeepanX
ejxnZehDuw
aaxxCbmaal
"}
