"a" = (/obj/storage/crate,/obj/random_item_spawner/tools_w_igloves/one_or_zero,/turf/floor/grime,/area/dmm_suite/clear_area)
"b" = (/obj/decal/cleanable/rust,/turf/floor/grime,/area/dmm_suite/clear_area)
"e" = (/obj/storage/crate,/obj/random_item_spawner/prosthetics,/obj/random_item_spawner/med_kit/maybe_few,/turf/floor/grime,/area/dmm_suite/clear_area)
"f" = (/turf/floor/grime,/area/dmm_suite/clear_area)
"h" = (/obj/decal/cleanable/dirt/random,/turf/floor/grime,/area/dmm_suite/clear_area)
"n" = (/obj/storage/crate,/obj/random_item_spawner/shoe/maybe_few,/obj/random_item_spawner/desk_stuff/one_or_zero,/turf/floor/grime,/area/dmm_suite/clear_area)
"t" = (/obj/storage/crate,/obj/random_item_spawner/snacks/maybe_few,/turf/floor/grime,/area/dmm_suite/clear_area)
"C" = (/obj/storage/closet,/obj/random_item_spawner/tools_w_igloves/one_or_zero,/obj/random_item_spawner/mask/one_or_zero,/obj/decal/cleanable/dirt/random,/turf/floor/orangeblack,/area/dmm_suite/clear_area)
"E" = (/obj/machinery/light{dir = 8},/turf/floor/grime,/area/dmm_suite/clear_area)
"I" = (/obj/storage/crate/materials,/obj/random_item_spawner/tools/maybe_few,/turf/floor/grime,/area/dmm_suite/clear_area)
"K" = (/obj/storage/crate,/obj/random_item_spawner/junk/maybe_few,/turf/floor/grime,/area/dmm_suite/clear_area)
"M" = (/obj/decal/floatingtiles/loose/random,/turf/floor/plating/random,/area/dmm_suite/clear_area)
"S" = (/obj/decal/cleanable/dirt/random,/turf/floor/orangeblack,/area/dmm_suite/clear_area)
"Y" = (/obj/decal/cleanable/rust/jen,/obj/storage/closet,/obj/random_item_spawner/peripherals/one_or_zero,/obj/random_item_spawner/junk/maybe_few,/turf/floor/grime,/area/dmm_suite/clear_area)

(1,1,1) = {"
SaIeY
EffMh
bnKtC
"}
