"a" = (/turf/floor/grime,/area/dmm_suite/clear_area)
"c" = (/obj/storage/crate,/obj/random_item_spawner/prosthetics,/obj/random_item_spawner/med_kit/maybe_few,/turf/floor/grime,/area/dmm_suite/clear_area)
"d" = (/obj/decal/cleanable/dirt/random,/turf/floor/orangeblack,/area/dmm_suite/clear_area)
"m" = (/obj/storage/crate/materials,/obj/random_item_spawner/tools/maybe_few,/turf/floor/grime,/area/dmm_suite/clear_area)
"o" = (/obj/storage/crate,/obj/random_item_spawner/snacks/maybe_few,/turf/floor/grime,/area/dmm_suite/clear_area)
"v" = (/obj/decal/cleanable/rust,/turf/floor/grime,/area/dmm_suite/clear_area)
"x" = (/obj/decal/cleanable/dirt/random,/obj/storage/crate/trench_loot/weapons,/turf/floor/grime,/area/dmm_suite/clear_area)
"M" = (/obj/decal/floatingtiles/loose/random,/turf/floor/plating/random,/area/dmm_suite/clear_area)
"N" = (/obj/decal/cleanable/rust/jen,/obj/storage/closet,/obj/random_item_spawner/peripherals/one_or_zero,/obj/random_item_spawner/junk/maybe_few,/turf/floor/grime,/area/dmm_suite/clear_area)
"O" = (/obj/storage/crate,/obj/random_item_spawner/tools_w_igloves/one_or_zero,/turf/floor/grime,/area/dmm_suite/clear_area)
"Q" = (/obj/machinery/light{dir = 8},/turf/floor/grime,/area/dmm_suite/clear_area)
"R" = (/obj/storage/crate,/obj/random_item_spawner/shoe/maybe_few,/obj/random_item_spawner/desk_stuff/one_or_zero,/turf/floor/grime,/area/dmm_suite/clear_area)
"U" = (/obj/storage/crate,/obj/random_item_spawner/junk/maybe_few,/turf/floor/grime,/area/dmm_suite/clear_area)
"X" = (/obj/storage/closet,/obj/random_item_spawner/tools_w_igloves/one_or_zero,/obj/random_item_spawner/mask/one_or_zero,/obj/decal/cleanable/dirt/random,/turf/floor/orangeblack,/area/dmm_suite/clear_area)

(1,1,1) = {"
dOmcN
QaaMx
vRUoX
"}
