//MAP CONVERTED BY dmm2tgm.py THIS HEADER COMMENT PREVENTS RECONVERSION, DO NOT REMOVE
"a" = (
/turf/space,
/area/dmm_suite/clear_area)
"b" = (
/obj/machinery/shuttle/engine/propulsion{
	dir = 10;
	icon_state = "alt_propulsion"
	},
/turf/space,
/area/dmm_suite/clear_area)
"c" = (
/turf/floor/grime,
/area/dmm_suite/clear_area)
"f" = (
/obj/machinery/door/airlock/pyro/maintenance{
	dir = 4
	},
/turf/floor/grime,
/area/dmm_suite/clear_area)
"j" = (
/obj/machinery/shuttle/engine/heater{
	dir = 1;
	icon_state = "alt_heater-L"
	},
/obj/wingrille_spawn/classic,
/turf/floor/plating,
/area/dmm_suite/clear_area)
"m" = (
/obj/lattice{
	dir = 4;
	icon_state = "lattice-dir";
	tag = "icon-lattice-dir (EAST)"
	},
/turf/space,
/area/dmm_suite/clear_area)
"n" = (
/obj/machinery/light/beacon,
/turf/floor/plating/random,
/area/dmm_suite/clear_area)
"o" = (
/turf/wall/airbridge,
/area/dmm_suite/clear_area)
"p" = (
/obj/machinery/shuttle/engine/heater{
	dir = 1;
	icon_state = "alt_heater-R"
	},
/obj/wingrille_spawn/classic,
/turf/floor/plating,
/area/dmm_suite/clear_area)
"q" = (
/obj/landmark/random_ship_room/room3x3,
/turf/floor/grime,
/area/dmm_suite/clear_area)
"r" = (
/obj/decal/cleanable/mess/random_litter,
/turf/floor/grime,
/area/dmm_suite/clear_area)
"t" = (
/turf/floor/airbridge,
/area/dmm_suite/clear_area)
"v" = (
/obj/machinery/shuttle/engine/heater{
	dir = 1;
	icon_state = "alt_heater-M"
	},
/obj/wingrille_spawn/classic,
/turf/floor/plating,
/area/dmm_suite/clear_area)
"w" = (
/obj/storage/closet/fire,
/turf/floor/carpet/grime,
/area/dmm_suite/clear_area)
"y" = (
/obj/machinery/door/airlock/pyro/external,
/turf/floor/grime,
/area/dmm_suite/clear_area)
"z" = (
/obj/decal/cleanable/dirt/random,
/turf/floor/carpet/grime,
/area/dmm_suite/clear_area)
"A" = (
/obj/landmark/random_ship_room/room5x3,
/turf/floor/grime,
/area/dmm_suite/clear_area)
"B" = (
/turf/floor/carpet/grime,
/area/dmm_suite/clear_area)
"F" = (
/obj/computerframe,
/turf/floor/carpet/grime,
/area/dmm_suite/clear_area)
"G" = (
/obj/wingrille_spawn/classic,
/turf/floor/plating/random,
/area/dmm_suite/clear_area)
"I" = (
/obj/machinery/shuttle/engine/propulsion{
	dir = 5;
	icon_state = "alt_propulsion"
	},
/turf/space,
/area/dmm_suite/clear_area)
"K" = (
/obj/machinery/door/airlock/pyro/maintenance,
/turf/floor/grime,
/area/dmm_suite/clear_area)
"L" = (
/obj/decoration/damagedchair,
/turf/floor/carpet/grime,
/area/dmm_suite/clear_area)
"M" = (
/obj/table/auto,
/obj/machinery/phone,
/turf/floor/carpet/grime,
/area/dmm_suite/clear_area)
"N" = (
/obj/decal/floatingtiles/loose/random,
/turf/floor/plating/random,
/area/dmm_suite/clear_area)
"P" = (
/obj/decoration/decorativeplant/plant2,
/turf/floor/carpet/grime,
/area/dmm_suite/clear_area)
"Q" = (
/obj/decal/cleanable/dirt/random,
/turf/floor/grime,
/area/dmm_suite/clear_area)
"R" = (
/obj/decal/cleanable/dirt/random,
/obj/machinery/light{
	dir = 8;
	icon_state = "tube1";
	tag = ""
	},
/turf/floor/carpet/grime,
/area/dmm_suite/clear_area)
"T" = (
/obj/machinery/light{
	dir = 8;
	icon_state = "tube1";
	tag = ""
	},
/turf/floor/grime,
/area/dmm_suite/clear_area)
"U" = (
/turf/variableTurf/random_ship_wall,
/area/dmm_suite/clear_area)
"W" = (
/obj/machinery/shuttle/engine/propulsion{
	dir = 9;
	icon_state = "alt_propulsion"
	},
/turf/space,
/area/dmm_suite/clear_area)

(1,1,1) = {"
a
a
a
a
a
a
a
a
a
a
a
a
a
a
a
a
a
a
a
a
a
a
a
a
a
"}
(2,1,1) = {"
a
a
a
a
a
a
a
a
a
a
a
a
a
a
a
a
a
a
a
a
a
a
a
a
a
"}
(3,1,1) = {"
a
a
a
a
a
a
a
a
a
a
a
a
a
a
a
a
a
a
a
a
a
a
a
a
a
"}
(4,1,1) = {"
a
a
a
a
a
a
a
a
a
a
a
a
a
a
a
a
a
a
a
a
a
a
a
a
a
"}
(5,1,1) = {"
a
a
a
a
a
a
a
a
a
a
a
a
a
a
a
a
a
a
a
a
a
a
a
a
a
"}
(6,1,1) = {"
a
a
a
a
a
a
a
a
a
a
a
a
a
a
a
a
a
a
a
a
a
a
a
a
a
"}
(7,1,1) = {"
a
a
a
a
a
a
a
a
a
a
a
a
a
a
a
a
a
a
a
a
a
a
a
a
a
"}
(8,1,1) = {"
a
a
n
a
a
a
n
a
a
a
n
a
a
a
a
a
a
a
a
a
a
a
a
a
a
"}
(9,1,1) = {"
a
a
m
a
a
a
m
a
a
a
m
a
a
a
a
a
a
a
a
a
a
a
a
a
a
"}
(10,1,1) = {"
a
a
m
a
a
a
m
a
a
a
m
a
a
a
a
a
a
a
a
a
a
a
a
a
a
"}
(11,1,1) = {"
a
a
m
a
a
a
m
a
a
a
m
a
a
a
a
a
a
a
a
a
a
a
a
a
a
"}
(12,1,1) = {"
a
a
m
a
a
a
m
a
a
a
m
a
U
U
G
G
G
a
a
a
a
a
a
a
a
"}
(13,1,1) = {"
o
o
U
U
G
U
G
U
G
U
G
U
U
R
B
P
G
G
a
a
a
a
a
a
a
"}
(14,1,1) = {"
t
t
y
c
c
T
N
c
Q
T
c
r
K
B
B
B
M
G
a
a
a
a
a
a
a
"}
(15,1,1) = {"
t
t
y
c
Q
c
c
c
c
c
c
c
U
w
z
L
F
G
a
a
a
a
a
a
a
"}
(16,1,1) = {"
o
o
U
U
U
U
U
r
c
N
U
U
U
U
U
G
G
U
a
a
a
a
a
a
a
"}
(17,1,1) = {"
a
a
U
c
c
A
K
c
c
Q
K
c
c
A
U
a
a
a
a
a
a
a
a
a
a
"}
(18,1,1) = {"
a
W
p
c
c
c
U
U
f
U
U
c
c
c
U
a
a
a
a
a
a
a
a
a
a
"}
(19,1,1) = {"
a
b
v
c
c
c
U
c
c
q
U
c
c
c
U
a
a
a
a
a
a
a
a
a
a
"}
(20,1,1) = {"
a
I
j
c
c
c
U
c
c
c
U
c
c
c
U
a
a
a
a
a
a
a
a
a
a
"}
(21,1,1) = {"
a
a
U
c
c
c
U
c
c
c
U
c
c
c
U
a
a
a
a
a
a
a
a
a
a
"}
(22,1,1) = {"
a
a
U
U
G
U
U
U
G
U
U
U
U
U
U
a
a
a
a
a
a
a
a
a
a
"}
(23,1,1) = {"
a
a
a
a
a
a
a
a
a
a
a
a
a
a
a
a
a
a
a
a
a
a
a
a
a
"}
(24,1,1) = {"
a
a
a
a
a
a
a
a
a
a
a
a
a
a
a
a
a
a
a
a
a
a
a
a
a
"}
(25,1,1) = {"
a
a
a
a
a
a
a
a
a
a
a
a
a
a
a
a
a
a
a
a
a
a
a
a
a
"}
(26,1,1) = {"
a
a
a
a
a
a
a
a
a
a
a
a
a
a
a
a
a
a
a
a
a
a
a
a
a
"}
(27,1,1) = {"
a
a
a
a
a
a
a
a
a
a
a
a
a
a
a
a
a
a
a
a
a
a
a
a
a
"}
(28,1,1) = {"
a
a
a
a
a
a
a
a
a
a
a
a
a
a
a
a
a
a
a
a
a
a
a
a
a
"}
(29,1,1) = {"
a
a
a
a
a
a
a
a
a
a
a
a
a
a
a
a
a
a
a
a
a
a
a
a
a
"}
(30,1,1) = {"
a
a
a
a
a
a
a
a
a
a
a
a
a
a
a
a
a
a
a
a
a
a
a
a
a
"}
