//MAP CONVERTED BY dmm2tgm.py THIS HEADER COMMENT PREVENTS RECONVERSION, DO NOT REMOVE
"a" = (
/turf/space,
/area/dmm_suite/clear_area)
"b" = (
/obj/machinery/shuttle/engine/heater{
	dir = 4;
	icon_state = "alt_heater-M"
	},
/obj/wingrille_spawn/classic,
/turf/floor/plating,
/area/dmm_suite/clear_area)
"d" = (
/obj/table/folding,
/obj/machinery/light/lamp/green{
	pixel_x = -6;
	pixel_y = 10
	},
/turf/floor/grime,
/area/dmm_suite/clear_area)
"g" = (
/obj/landmark/random_ship_room/room3x3,
/turf/floor/grime,
/area/dmm_suite/clear_area)
"j" = (
/obj/machinery/door/airlock/pyro/maintenance{
	dir = 4
	},
/turf/floor/grime,
/area/dmm_suite/clear_area)
"m" = (
/obj/machinery/light{
	dir = 4;
	icon_state = "tube1"
	},
/turf/floor/grime,
/area/dmm_suite/clear_area)
"n" = (
/obj/decoration/damagedchair,
/turf/floor/grime,
/area/dmm_suite/clear_area)
"o" = (
/obj/machinery/door/airlock/pyro/maintenance,
/turf/floor/grime,
/area/dmm_suite/clear_area)
"p" = (
/obj/computerframe,
/turf/floor/grime,
/area/dmm_suite/clear_area)
"t" = (
/obj/machinery/shuttle/engine/propulsion{
	dir = 4;
	icon_state = "alt_propulsion"
	},
/turf/space,
/area/dmm_suite/clear_area)
"u" = (
/obj/machinery/door/airlock/pyro/external,
/turf/floor/grime,
/area/dmm_suite/clear_area)
"x" = (
/obj/stool/bed/moveable,
/turf/floor/grime,
/area/dmm_suite/clear_area)
"B" = (
/obj/table/auto,
/obj/machinery/phone,
/turf/floor/grime,
/area/dmm_suite/clear_area)
"C" = (
/turf/variableTurf/random_ship_wall,
/area/dmm_suite/clear_area)
"F" = (
/turf/wall/airbridge,
/area/dmm_suite/clear_area)
"G" = (
/turf/floor/airbridge,
/area/dmm_suite/clear_area)
"H" = (
/obj/machinery/shuttle/engine/heater{
	dir = 4;
	icon_state = "alt_heater-L"
	},
/obj/wingrille_spawn/classic,
/turf/floor/plating,
/area/dmm_suite/clear_area)
"P" = (
/obj/wingrille_spawn/classic,
/turf/floor/plating/random,
/area/dmm_suite/clear_area)
"Q" = (
/obj/table/auto,
/obj/decoration/floralarrangement,
/turf/floor/grime,
/area/dmm_suite/clear_area)
"S" = (
/obj/machinery/light{
	dir = 1
	},
/turf/floor/grime,
/area/dmm_suite/clear_area)
"W" = (
/turf/floor/grime,
/area/dmm_suite/clear_area)

(1,1,1) = {"
a
a
a
a
a
a
a
a
a
a
a
a
a
a
a
a
a
a
a
a
a
a
a
a
a
"}
(2,1,1) = {"
a
a
a
a
a
a
a
a
a
a
a
a
a
a
a
a
a
a
a
a
a
a
a
a
a
"}
(3,1,1) = {"
a
a
a
a
a
a
a
a
a
a
a
a
a
a
a
a
a
a
a
a
a
a
a
a
a
"}
(4,1,1) = {"
a
a
a
a
a
a
a
a
a
a
a
a
a
a
a
a
a
a
a
a
a
a
a
a
a
"}
(5,1,1) = {"
a
a
a
a
a
a
a
a
a
a
a
a
a
a
a
a
a
a
a
a
a
a
a
a
a
"}
(6,1,1) = {"
a
a
a
a
C
P
P
P
C
a
a
a
a
a
a
a
a
a
a
a
a
a
a
a
a
"}
(7,1,1) = {"
a
a
a
C
C
Q
B
p
C
C
a
a
a
a
a
a
a
a
a
a
a
a
a
a
a
"}
(8,1,1) = {"
a
a
a
P
W
W
n
W
x
P
a
a
a
a
a
a
a
a
a
a
a
a
a
a
a
"}
(9,1,1) = {"
a
a
a
C
W
m
W
m
d
C
a
a
a
a
a
a
a
a
a
a
a
a
a
a
a
"}
(10,1,1) = {"
a
a
a
C
j
C
C
C
C
C
a
a
a
a
a
a
a
a
a
a
a
a
a
a
a
"}
(11,1,1) = {"
a
a
a
C
W
C
W
W
g
C
a
a
a
a
a
a
a
a
a
a
a
a
a
a
a
"}
(12,1,1) = {"
a
a
a
P
W
o
W
W
W
P
a
a
a
a
a
a
a
a
a
a
a
a
a
a
a
"}
(13,1,1) = {"
F
F
F
C
S
C
W
W
W
C
a
a
a
a
a
a
a
a
a
a
a
a
a
a
a
"}
(14,1,1) = {"
G
G
G
u
W
C
C
C
C
C
a
a
a
a
a
a
a
a
a
a
a
a
a
a
a
"}
(15,1,1) = {"
G
G
G
u
W
C
W
W
g
C
a
a
a
a
a
a
a
a
a
a
a
a
a
a
a
"}
(16,1,1) = {"
F
F
F
C
S
o
W
W
W
P
a
a
a
a
a
a
a
a
a
a
a
a
a
a
a
"}
(17,1,1) = {"
a
a
a
C
W
C
W
W
W
C
a
a
a
a
a
a
a
a
a
a
a
a
a
a
a
"}
(18,1,1) = {"
a
a
a
b
b
H
C
b
b
H
a
a
a
a
a
a
a
a
a
a
a
a
a
a
a
"}
(19,1,1) = {"
a
a
a
t
t
t
a
t
t
t
a
a
a
a
a
a
a
a
a
a
a
a
a
a
a
"}
(20,1,1) = {"
a
a
a
a
a
a
a
a
a
a
a
a
a
a
a
a
a
a
a
a
a
a
a
a
a
"}
(21,1,1) = {"
a
a
a
a
a
a
a
a
a
a
a
a
a
a
a
a
a
a
a
a
a
a
a
a
a
"}
(22,1,1) = {"
a
a
a
a
a
a
a
a
a
a
a
a
a
a
a
a
a
a
a
a
a
a
a
a
a
"}
(23,1,1) = {"
a
a
a
a
a
a
a
a
a
a
a
a
a
a
a
a
a
a
a
a
a
a
a
a
a
"}
(24,1,1) = {"
a
a
a
a
a
a
a
a
a
a
a
a
a
a
a
a
a
a
a
a
a
a
a
a
a
"}
(25,1,1) = {"
a
a
a
a
a
a
a
a
a
a
a
a
a
a
a
a
a
a
a
a
a
a
a
a
a
"}
(26,1,1) = {"
a
a
a
a
a
a
a
a
a
a
a
a
a
a
a
a
a
a
a
a
a
a
a
a
a
"}
(27,1,1) = {"
a
a
a
a
a
a
a
a
a
a
a
a
a
a
a
a
a
a
a
a
a
a
a
a
a
"}
(28,1,1) = {"
a
a
a
a
a
a
a
a
a
a
a
a
a
a
a
a
a
a
a
a
a
a
a
a
a
"}
(29,1,1) = {"
a
a
a
a
a
a
a
a
a
a
a
a
a
a
a
a
a
a
a
a
a
a
a
a
a
"}
(30,1,1) = {"
a
a
a
a
a
a
a
a
a
a
a
a
a
a
a
a
a
a
a
a
a
a
a
a
a
"}
