"ag" = (/obj/machinery/door/airlock/pyro/external,/turf/floor/plating/random,/area/dmm_suite/clear_area)
"bc" = (/obj/lattice{dir = 8; icon_state = "lattice-broken"},/turf/space,/area/dmm_suite/clear_area)
"bZ" = (/obj/decal/poster/wallsign/stencil/right/f,/obj/decoration/bullethole,/turf/wall/auto/supernorn,/area/dmm_suite/clear_area)
"du" = (/turf/floor/airless/plating/scorched,/area/dmm_suite/clear_area)
"dQ" = (/obj/machinery/shuttle/engine/heater{dir = 4; icon_state = "alt_heater-L"},/turf/space,/area/dmm_suite/clear_area)
"dX" = (/obj/decoration/collapsedwall,/turf/floor/airless/plating/scorched,/area/dmm_suite/clear_area)
"eh" = (/obj/item/furniture_parts/table/reinforced,/turf/floor/airless/scorched2,/area/dmm_suite/clear_area)
"em" = (/obj/storage/closet/emergency,/turf/floor/airless/scorched2,/area/dmm_suite/clear_area)
"fn" = (/turf/floor/airless/scorched2,/area/dmm_suite/clear_area)
"fs" = (/obj/landmark/random_ship_room/cargo5x3,/turf/floor/airless/plating/scorched,/area/dmm_suite/clear_area)
"hv" = (/obj/decal/floatingtiles/loose/random,/obj/machinery/light{dir = 1},/turf/floor/airless/plating/scorched,/area/dmm_suite/clear_area)
"js" = (/obj/lattice{icon_state = "lattice-broken"},/turf/space,/area/dmm_suite/clear_area)
"jy" = (/obj/decal/poster/wallsign/stencil/right/a,/obj/decoration/bullethole,/turf/wall/auto/supernorn,/area/dmm_suite/clear_area)
"jT" = (/obj/grille/steel/broken/corroded,/turf/floor/airless/scorched2,/area/dmm_suite/clear_area)
"ng" = (/obj/decal/cleanable/dirt/random,/turf/floor/grime,/area/dmm_suite/clear_area)
"np" = (/obj/lattice{dir = 1; icon_state = "lattice-broken"},/turf/space,/area/dmm_suite/clear_area)
"nY" = (/obj/decal/fakeobjects/lighttube_broken,/turf/floor/airless/plating/scorched,/area/dmm_suite/clear_area)
"oc" = (/obj/decal/fakeobjects/apc_broken,/turf/wall/auto/supernorn,/area/dmm_suite/clear_area)
"oi" = (/obj/item/raw_material/shard/glass,/obj/grille/steel/broken/corroded,/turf/floor/airless/plating/scorched,/area/dmm_suite/clear_area)
"oC" = (/turf/floor/airless/scorched,/area/dmm_suite/clear_area)
"ql" = (/obj/lattice{dir = 4; icon_state = "lattice-broken"},/turf/space,/area/dmm_suite/clear_area)
"qF" = (/obj/wingrille_spawn/auto,/turf/floor/airless/grime,/area/dmm_suite/clear_area)
"tt" = (/obj/decal/cleanable/dirt/random,/turf/floor/airless/scorched2,/area/dmm_suite/clear_area)
"tH" = (/obj/dialogueobj/engineerscorpse,/turf/floor/airless/scorched,/area/dmm_suite/clear_area)
"up" = (/obj/grille/classic,/turf/floor/airless/plating/scorched,/area/dmm_suite/clear_area)
"uH" = (/obj/machinery/door/airlock/pyro/maintenance{dir = 4},/turf/floor/grime,/area/dmm_suite/clear_area)
"xT" = (/obj/random_item_spawner/loot_crate,/obj/machinery/light{dir = 1},/turf/floor/airless/plating/scorched,/area/dmm_suite/clear_area)
"zu" = (/obj/decal/floatingtiles/loose/random,/turf/floor/airless/plating/scorched,/area/dmm_suite/clear_area)
"zG" = (/obj/decoration/damagedchair,/turf/floor/airless/scorched2,/area/dmm_suite/clear_area)
"AD" = (/obj/lattice{dir = 8; icon_state = "lattice-broken"},/obj/lattice{dir = 1; icon_state = "lattice-broken"},/turf/space,/area/dmm_suite/clear_area)
"AE" = (/obj/machinery/light/small/broken,/turf/floor/airless/scorched,/area/dmm_suite/clear_area)
"BS" = (/obj/random_item_spawner/junk/maybe_few,/turf/floor/grime,/area/dmm_suite/clear_area)
"BV" = (/turf/wall/auto/supernorn,/area/dmm_suite/clear_area)
"CV" = (/turf/floor/grime,/area/dmm_suite/clear_area)
"DP" = (/obj/table/auto,/obj/machinery/phone,/turf/floor/grime,/area/dmm_suite/clear_area)
"EW" = (/obj/machinery/shuttle/engine/heater{dir = 4; icon_state = "alt_heater-R"},/turf/space,/area/dmm_suite/clear_area)
"Ho" = (/obj/decal/cleanable/mess/random_litter,/turf/floor/grime,/area/dmm_suite/clear_area)
"HD" = (/obj/decoration/bullethole,/turf/wall/auto/supernorn,/area/dmm_suite/clear_area)
"HS" = (/obj/grille/steel/broken,/turf/floor/airless/plating/scorched,/area/dmm_suite/clear_area)
"IO" = (/obj/grille/steel/broken/corroded,/turf/floor/airless/plating/scorched,/area/dmm_suite/clear_area)
"JT" = (/obj/decal/fakeobjects/airmonitor_broken,/turf/wall/auto/supernorn,/area/dmm_suite/clear_area)
"Ko" = (/obj/lattice,/turf/space,/area/dmm_suite/clear_area)
"LE" = (/obj/decal/floatingtiles/loose/random,/turf/floor/plating/random,/area/dmm_suite/clear_area)
"MT" = (/turf/space,/area/dmm_suite/clear_area)
"Ol" = (/obj/decal/poster/wallsign/stencil/right/h,/turf/wall/auto/supernorn,/area/dmm_suite/clear_area)
"OF" = (/mob/living/carbon/human/npc/assistant,/obj/random_item_spawner/junk/maybe_few,/turf/floor/airless/scorched2,/area/dmm_suite/clear_area)
"OK" = (/obj/structure/girder,/turf/floor/airless/plating/scorched,/area/dmm_suite/clear_area)
"OX" = (/obj/machinery/shuttle/engine/heater{dir = 4; icon_state = "alt_heater-M"},/turf/space,/area/dmm_suite/clear_area)
"Pr" = (/obj/decal/poster/wallsign/stencil/right/n,/turf/wall/auto/supernorn,/area/dmm_suite/clear_area)
"PU" = (/obj/random_item_spawner/junk/maybe_few,/turf/floor/airless/scorched,/area/dmm_suite/clear_area)
"Sb" = (/obj/random_item_spawner/junk/maybe_few,/turf/floor/airless/plating/scorched,/area/dmm_suite/clear_area)
"TT" = (/obj/item/raw_material/shard/glass,/turf/floor/grime,/area/dmm_suite/clear_area)
"Uh" = (/obj/decal/fakeobjects/firealarm_broken,/turf/wall/auto/supernorn,/area/dmm_suite/clear_area)
"VV" = (/obj/grille/steel/broken,/turf/floor/grime,/area/dmm_suite/clear_area)
"WC" = (/obj/machinery/shuttle/engine/propulsion{dir = 4; icon_state = "alt_propulsion"},/turf/space,/area/dmm_suite/clear_area)
"Xj" = (/obj/wingrille_spawn/auto,/turf/floor/grime,/area/dmm_suite/clear_area)
"XB" = (/obj/decal/fakeobjects/lighttube_broken,/obj/grille/steel/broken,/turf/floor/airless/plating/scorched,/area/dmm_suite/clear_area)
"XP" = (/obj/decal/cleanable/mess/random_litter,/turf/floor/airless/plating/scorched,/area/dmm_suite/clear_area)
"Yb" = (/obj/decal/cleanable/dirt/random,/turf/floor/airless/plating/scorched,/area/dmm_suite/clear_area)
"Yt" = (/obj/machinery/door/airlock/pyro/maintenance,/turf/floor/grime,/area/dmm_suite/clear_area)
"YU" = (/obj/decal/floatingtiles/loose/random,/obj/random_item_spawner/junk/maybe_few,/turf/floor/airless/plating/scorched,/area/dmm_suite/clear_area)
"Zq" = (/obj/decoration/bustedmantapc,/turf/floor/airless/scorched2,/area/dmm_suite/clear_area)

(1,1,1) = {"
MTMTMTMTMTMTMTMTMTMTMTMTMTMTMTMTMTMTMTMTMTMTMTMTMTMTMTMTMTMT
MTMTMTMTMTMTMTMTMTMTMTMTMTMTMTMTMTMTMTMTMTMTMTMTMTMTMTMTMTMT
MTMTMTMTMTMTMTMTMTMTMTMTMTMTMTMTMTMTMTMTMTMTMTMTMTMTMTMTMTMT
MTMTMTMTMTMTMTMTMTMTMTMTMTMTMTMTMTMTMTMTMTMTMTMTMTMTMTMTMTMT
MTMTMTMTXjdXXjHDHDJTqFMTMTMTMTMTMTMTMTMTMTMTMTMTMTMTMTMTMTMT
MTMTMToiXjttttemBVOFKoxTMTMTMTMTMTMTMTMTMTMTMTMTMTMTMTMTMTMT
MTMTMTTTehPUoCoCuHfnXPduMTMTMTMTMTMTMTMTMTMTMTMTMTMTMTMTMTMT
MTMTMTduZqzGzuDPocYbfnKobcMTMTMTMTMTMTMTBVBVBVMTMTMTMTMTMTMT
MTMTMTupIOnYKoOKzuOKKoADMTMTMTMTMTMTMTqlKohvSbMTMTMTMTMTMTMT
MTMTMTMTXjHDKobczuKoADMTMTMTMTMTMTMTMTMTnpqlKobcMTMTMTMTMTMT
MTMTMTMTMTMTnpMTMTnpMTMTMTMTMTMTMTMTMTMTMTMTnpMTMTMTMTMTMTMT
MTMTMTMTMTMTMTMTMTMTMTMTMTMTMTMTMTjsLEagOKHDjsBVBVMTMTMTMTMT
MTMTMTMTMTMTMTMTMTMTMTMTMTMTMTMTqlKodufnfnduKoLEEWWCMTMTMTMT
MTMTMTMTMTMTMTMTMTMTMTMTMTMTMTqlKoOKYbjTduzuoCBSOXWCMTMTMTMT
MTMTMTMTMTMTMTMTMTMTMTMTMTMTMTMTduzuSbLEAEHongXBdQWCMTMTMTMT
MTMTMTMTMTMTMTMTMTMTMTMTMTMTMTMTMTBVdXCVHDBVYtBVUhBVBVBVMTMT
MTMTMTMTMTMTMTMTMTMTMTMTMTMTMTMTqlKoOKoCYUBVoCoCfndufnBVMTMT
MTMTMTMTMTMTMTMTMTMTMTMTMTMTMTMTjsHDHSzuoCBVdufnfnoCoCBVMTMT
MTMTMTMTMTMTMTMTMTMTMTMTMTMTMTqlKoKoKodutHBVfsdududufnBVMTMT
MTMTMTMTMTMTMTMTMTMTMTMTMTMTMTMTPrKoADVVbZjyOlOKBVVVBVBVMTMT
MTMTMTMTMTMTMTMTMTMTMTMTMTMTMTMTMTMTMTMTMTMTMTMTMTMTMTMTMTMT
MTMTMTMTMTMTMTMTMTMTMTMTMTMTMTMTMTMTMTMTMTMTMTMTMTMTMTMTMTMT
MTMTMTMTMTMTMTMTMTMTMTMTMTMTMTMTMTMTMTMTMTMTMTMTMTMTMTMTMTMT
MTMTMTMTMTMTMTMTMTMTMTMTMTMTMTMTMTMTMTMTMTMTMTMTMTMTMTMTMTMT
MTMTMTMTMTMTMTMTMTMTMTMTMTMTMTMTMTMTMTMTMTMTMTMTMTMTMTMTMTMT
"}
