"a" = (/obj/storage/crate/materials,/turf/floor/airless/grime,/area/space)
"f" = (/turf/floor/airless/grime,/area/space)
"s" = (/obj/decal/cleanable/cobweb2,/turf/floor/airless/grime,/area/space)
"F" = (/obj/storage/crate/pizza,/turf/floor/airless/grime,/area/space)
"J" = (/obj/storage/crate/packing,/turf/floor/airless/grime,/area/space)
"T" = (/obj/reagent_dispensers/fueltank,/turf/floor/airless/grime,/area/space)

(1,1,1) = {"
Tfs
Jff
afF
"}
