"a" = (/obj/machinery/portable_atmospherics/canister/toxins,/obj/decal/cleanable/dirt/random,/turf/floor/plating/random,/area/dmm_suite/clear_area)
"i" = (/obj/machinery/portable_atmospherics/canister/toxins,/turf/floor/plating/random,/area/dmm_suite/clear_area)
"G" = (/obj/machinery/portable_atmospherics/canister/toxins,/obj/decal/cleanable/oil/streak,/turf/floor/plating/random,/area/dmm_suite/clear_area)
"I" = (/obj/machinery/portable_atmospherics/canister/toxins,/obj/decal/cleanable/oil,/turf/floor/plating/random,/area/dmm_suite/clear_area)

(1,1,1) = {"
iaG
Iii
aiI
"}
