"a" = (/obj/reagent_dispensers/still,/obj/decal/cleanable/dirt/random,/turf/floor/wood/six,/area/dmm_suite/clear_area)
"d" = (/obj/reagent_dispensers/still,/obj/decal/cleanable/dirt/random,/obj/machinery/light/small{dir = 4; icon_state = "bulb1"},/turf/floor/wood/six,/area/dmm_suite/clear_area)
"g" = (/turf/floor/wood/six,/area/dmm_suite/clear_area)
"j" = (/obj/item/satchel/hydro,/obj/decal/cleanable/dirt/random,/turf/floor/wood/six,/area/dmm_suite/clear_area)
"r" = (/obj/decal/cleanable/fungus,/turf/floor/wood/six,/area/dmm_suite/clear_area)
"M" = (/obj/decal/cleanable/mess/sodacan,/turf/floor/wood/six,/area/dmm_suite/clear_area)
"W" = (/obj/stool/chair{dir = 1},/turf/floor/wood/six,/area/dmm_suite/clear_area)
"Y" = (/obj/reagent_dispensers/still,/turf/floor/wood/six,/area/dmm_suite/clear_area)
"Z" = (/obj/storage/crate/packing,/obj/item/reagent_containers/food/drinks/bottle/vodka,/obj/item/reagent_containers/food/drinks/bottle/vodka,/obj/item/reagent_containers/food/drinks/bottle/vodka,/obj/item/reagent_containers/food/drinks/bottle/vodka,/obj/item/reagent_containers/food/drinks/bottle/vodka,/obj/item/reagent_containers/food/drinks/bottle/fancy_beer,/obj/item/reagent_containers/food/drinks/bottle/fancy_beer,/turf/floor/wood/six,/area/dmm_suite/clear_area)

(1,1,1) = {"
jMY
rgd
ZWa
"}
